A	AH
A(2)	EY
ABANDONED	AH B AE N D AH N D
ABASHIDZE	AE B AH SH AH D Z
ABC	AE B K
ABDUCTION	AE B D AH K SH AH N
ABDUCTION(2)	AH B D AH K SH AH N
ABILITY	AH B IH L AH T IY
ABLE	EY B AH L
ABOUT	AH B AW T
ABOVE	AH B AH V
ABSENT	AE B S AH N T
ABSOLUTE	AE B S AH L UW T
ABSOLUTELY	AE B S AH L UW T L IY
ABSURDISM	AH B S ER D IH Z AH M
ABSURDITY	AH B S ER D AH T IY
ABSURDLY	AH B S ER D L IY
ABYSS	AH B IH S
ACADEMY	AH K AE D AH M IY
ACCENT	AH K S EH N T
ACCENT(2)	AE K S EH N T
ACCENTUATE	AE K S EH N CH UW EY T
ACCEPTANCE	AE K S EH P T AH N S
ACCEPTANCE(2)	AH K S EH P T AH N S
ACCIDENT	AE K S AH D AH N T
ACCIDENTAL	AE K S AH D EH N T AH L
ACCIDENTAL(2)	AE K S AH D EH N AH L
ACCIDENTALLY	AE K S AH D EH N T AH L IY
ACCIDENTALLY(2)	AE K S AH D EH N AH L IY
ACCOMPANIES	AH K AH M P AH N IY Z
ACCURATE	AE K Y ER AH T
ACCUSATION	AE K Y AH Z EY SH AH N
ACCUSATION(2)	AE K Y UW Z EY SH AH N
ACCUSTOMED	AH K AH S T AH M D
ACHIEVE	AH CH IY V
ACHIEVEMENTS	AH CH IY V M AH N T S
ACROSS	AH K R AO S
ACT	AE K T
ACTED	AE K T IH D
ACTING	AE K T IH NG
ACTION	AE K SH AH N
ACTIVISTS	AE K T IH V IH S T S
ACTOR	AE K T ER
ACTORS	AE K T ER Z
ACTRESS	AE K T R AH S
ACTRESSES	AE K T R AH S IH Z
ACTS	AE K T S
ACTS(2)	AE K S
ACTUAL	AE K CH AH W AH L
ACTUAL(2)	AE K SH AH L
ACTUALLY	AE K CH UW AH L IY
ACTUALLY(2)	AE K CH L IY
ACTUALLY(3)	AE K SH AH L IY
ADAM	AE D AH M
ADAPTATION	AE D AH P T EY SH AH N
ADAPTING	AH D AE P T IH NG
ADAPTS	AH D AE P T S
ADD	AE D
ADDED	AE D IH D
ADDITION	AH D IH SH AH N
ADDITIONS	AH D IH SH AH N Z
ADDRESS	AE D R EH S
ADDRESSED	AH D R EH S T
ADJACENT	AH JH EY S AH N T
ADMINISTRATION	AE D M IH N IH S T R EY SH AH N
ADMIRABLE	AE D M ER AH B AH L
ADMIRABLE(2)	AE D M R AH B AH L
ADMIRE	AE D M AY R
ADMIT	AH D M IH T
ADMITS	AH D M IH T S
ADRIAN	EY D R IY AH N
ADULT	AH D AH L T
ADULT(2)	AE D AH L T
ADULTS	AH D AH L T S
ADULTS(2)	AE D AH L T S
ADVENTURE	AE D V EH N CH ER
ADVENTURE(2)	AH D V EH N CH ER
ADVERSARY	AE D V ER S EH R IY
ADVICE	AE D V AY S
ADVICE(2)	AH D V AY S
ADVICES	AH D V AY S IH Z
ADVISED	AE D V AY Z D
ADVISED(2)	AH D V AY Z D
AESTHETIC	EH S TH EH T IH K
AFFAIR	AH F EH R
AFFECT	AH F EH K T
AFFECTING	AH F EH K T IH NG
AFFECTION	AH F EH K SH AH N
AFFLUENT	AE F L UW AH N T
AFFORD	AH F AO R D
AFOREMENTIONED	AH F AO R M EH N SH AH N D
AFRICA	AE F R IH K AA
AFTER	AE F T ER
AFTERNOON	AE F T ER N UW N
AGAIN	AH G EH N
AGAIN(2)	AH G EY N
AGAINST	AH G EH N S T
AGAINST(2)	AH G EY N S T
AGE	EY JH
AGED	EY JH D
AGED(2)	EY JH IH D
AGENCY	EY JH AH N S IY
AGENT	EY JH AH N T
AGENTS	EY JH AH N T S
AGES	EY JH IH Z
AGING	EY JH IH NG
AGO	AH G OW
AGREE	AH G R IY
AGREED	AH G R IY D
AGREES	AH G R IY Z
AH	AA
AHEAD	AH HH EH D
AIM	EY M
AIMLESS	EY M L AH S
AIR	EH R
AIRED	EH R D
AIRMEN	EH R M EH N
AL	AE L
ALAN	AE L AH N
ALARM	AH L AA R M
ALARMISTS	AH L AA R M IH S T S
ALAS	AH L AE S
ALCOHOLIC	AE L K AH HH AA L IH K
ALEXANDER	AE L IH G Z AE N D ER
ALICE	AE L IH S
ALIKE	AH L AY K
ALL	AO L
ALLEGEDLY	AH L EH JH AH D L IY
ALLEN	AE L AH N
ALLOW	AH L AW
ALLOWS	AH L AW Z
ALMOST	AO L M OW S T
ALOHA	AH L OW HH AA
ALONE	AH L OW N
ALONG	AH L AO NG
ALONGÂ—NO	AH L AA N G N OW
ALREADY	AO L R EH D IY
ALREADY(2)	AO R EH D IY
ALRIGHT	AO L R AY T
ALSO	AO L S OW
ALTERNATE	AO L T ER N AH T
ALTERNATE(2)	AO L T ER N EY T
ALTERNATIVES	AO L T ER N AH T IH V Z
ALTHOUGH	AO L DH OW
ALWAYS	AO L W EY Z
ALWAYS(2)	AO L W IY Z
ALZHEIMER	AE L Z HH AY M ER
ALZHEIMER(2)	AA L T S HH AY M ER
AM	AE M
AM(2)	EY EH M
AMAZED	AH M EY Z D
AMAZING	AH M EY Z IH NG
AMAZINGLY	AH M EY Z IH NG L IY
AMELIE	AH M IY L AY
AMERICA	AH M EH R IH K AH
AMERICAN	AH M EH R IH K AH N
AMERICANS	AH M EH R IH K AH N Z
AMIABLE	EY M IY AH B AH L
AMONG	AH M AH NG
AMORAL	EY M AO R AH L
AMOUNT	AH M AW N T
AMOUNTS	AH M AW N T S
AMROHI	AE M R AH HH IY
AMURO	AE M Y AH R OW
AMUSING	AH M Y UW Z IH NG
AN	AE N
AN(2)	AH N
ANCIENT	EY N CH AH N T
ANCIENT(2)	EY N SH AH N T
AND	AH N D
AND(2)	AE N D
ANDERS	AE N D ER Z
ANDERSON	AE N D ER S AH N
ANGELA	AE N JH AH L AH
ANGLES	AE NG G AH L Z
ANGUISH	AE NG G W IH SH
ANIMALS	AE N AH M AH L Z
ANIMATED	AE N AH M EY T IH D
ANIMATION	AE N AH M EY SH AH N
ANIMATRONIC	AE N AH M AE T R AH N AH K
ANNALS	AE N AH L Z
ANNOYING	AH N OY IH NG
ANOTHER	AH N AH DH ER
ANSWER	AE N S ER
ANSWERS	AE N S ER Z
ANT	AE N T
ANTHONY	AE N TH AO N IY
ANTICIPATES	AE N T IH S AH P EY T S
ANTICIPATION	AE N T IH S AH P EY SH AH N
ANXIOUS	AE NG K SH AH S
ANXIOUS(2)	AE NG SH AH S
ANY	EH N IY
ANYHOW	EH N IY HH AW
ANYMORE	EH N IY M AO R
ANYONE	EH N IY W AH N
ANYTHING	EH N IY TH IH NG
ANYWAY	EH N IY W EY
ANYWHERE	EH N IY W EH R
ANYWHERE(2)	EH N IY HH W EH R
APART	AH P AA R T
APARTMENT	AH P AA R T M AH N T
APEL	AA P EH L
APLOMB	AH P L AA M
APPARENT	AH P EH R AH N T
APPARENTLY	AH P EH R AH N T L IY
APPEAL	AH P IY L
APPEALING	AH P IY L IH NG
APPEAR	AH P IH R
APPEARANCE	AH P IH R AH N S
APPEARED	AH P IH R D
APPLAUDED	AH P L AO D IH D
APPLE	AE P AH L
APPLICATION	AE P L AH K EY SH AH N
APPRECIATE	AH P R IY SH IY EY T
APPRECIATED	AH P R IY SH IY EY T IH D
APPRECIATING	AH P R IY SH IY EY T IH NG
APPRECIATION	AH P R IY SH IY EY SH AH N
APPROACH	AH P R OW CH
APPROPRIATE	AH P R OW P R IY AH T
APPROPRIATE(2)	AH P R OW P R IY EY T
APPROVAL	AH P R UW V AH L
APRIL	EY P R AH L
ARE	AA R
ARE(2)	ER
AREA	EH R IY AH
AREAS	EH R IY AH Z
AREN	AA R AH N
ARETHA	ER IY TH AH
ARGUABLY	AA R G Y UW AH B L IY
ARMAGEDDON	AA R M AH G EH D AH N
ARMY	AA R M IY
AROUND	ER AW N D
AROUND(2)	ER AW N
ARRIVAL	ER AY V AH L
ARRIVES	ER AY V Z
ARRIVING	ER AY V IH NG
ART	AA R T
ARTEMISIA	AA R T AH M IH ZH IY AH
ARTICULATE	AA R T IH K Y AH L EY T
ARTICULATE(2)	AA R T IH K Y AH L AH T
ARTIFICIAL	AA R T AH F IH SH AH L
ARTIFICIALLY	AA R T AH F IH SH AH L IY
ARTIST	AA R T AH S T
ARTIST(2)	AA R T IH S T
ARTISTIC	AA R T IH S T IH K
ARTISTS	AA R T IH S T S
ARTS	AA R T S
AS	AE Z
AS(2)	EH Z
ASHURA	AE SH AH R AH
ASIAN	EY ZH AH N
ASIDE	AH S AY D
ASKED	AE S K T
ASKED(2)	AE S T
ASPECTS	AE S P EH K T S
ASS	AE S
ASSASSIN	AH S AE S AH N
ASSAULT	AH S AO L T
ASSHOLE	AE S HH OW L
ASSUME	AH S UW M
ASSUMED	AH S UW M D
ASTAIRE	AH S T EH R
ASTRONOMICAL	AE S T R AH N AA M IH K AH L
AT	AE T
ATHINODOROS	AH TH IH N OW D ER AA S
ATLANTA	AE T L AE N T AH
ATMOSPHERE	AE T M AH S F IH R
ATMOSPHERIC	AE T M AH S F EH R IH K
ATTACK	AH T AE K
ATTACKED	AH T AE K T
ATTACKING	AH T AE K IH NG
ATTEMPT	AH T EH M P T
ATTEMPTING	AH T EH M P T IH NG
ATTEMPTS	AH T EH M P T S
ATTEND	AH T EH N D
ATTENTION	AH T EH N SH AH N
ATTIRED	AH T AY R D
ATTITUDE	AE T AH T UW D
ATTRACTION	AH T R AE K SH AH N
ATTRACTIVE	AH T R AE K T IH V
AUDIENCE	AA D IY AH N S
AUDIENCE(2)	AO D IY AH N S
AUDIENCES	AA D IY AH N S AH Z
AUDIENCES(2)	AO D IY AH N S AH Z
AUDLEY	AO D L IY
AUNT	AE N T
AUNT(2)	AO N T
AUR	AO R
AUSTRALIA	AO S T R EY L Y AH
AUSTRALIAN	AO S T R EY L Y AH N
AUTHENTIC	AH TH EH N T IH K
AUTHENTIC(2)	AO TH EH N T IH K
AUTHENTIC(3)	AO TH EH N IH K
AUTHENTIC(4)	AH TH EH N IH K
AUTHORITY	AH TH AO R AH T IY
AUTISM	AO T IH Z AH M
AVATAR	AE V AH T AA R
AVERAGE	AE V ER IH JH
AVERAGE(2)	AE V R IH JH
AVIATION	EY V IY EY SH AH N
AVOIDS	AH V OY D Z
AWARD	AH W AO R D
AWARE	AH W EH R
AWAY	AH W EY
AWESOME	AA S AH M
AWESOME(2)	AO S AH M
AWFUL	AA F AH L
AWFUL(2)	AO F AH L
AWHILE	AH W AY L
AWKWARD	AA K W ER D
AWKWARD(2)	AO K W ER D
B	B IY
BABBS	B AE B Z
BABIES	B EY B IY Z
BABY	B EY B IY
BACHELOR	B AE CH AH L ER
BACHELOR(2)	B AE CH L ER
BACK	B AE K
BACKGROUND	B AE K G R AW N D
BACON	B EY K AH N
BAD	B AE D
BAHRAIN	B AA R EY N
BAHRAIN(2)	B AY R EY N
BAKERSFIELD	B EY K ER Z F IY L D
BALANCE	B AE L AH N S
BALL	B AO L
BALLET	B AE L EY
BALLING	B AO L IH NG
BALLYHOOED	B AE L IY HH UW D
BAMBINO	B AE M B IY N OW
BANDS	B AE N D Z
BANG	B AE NG
BANTERING	B AE N T ER IH NG
BAR	B AA R
BARBARA	B AA R B ER AH
BARBARA(2)	B AA R B R AH
BARELY	B EH R L IY
BARR	B AA R
BARRYMORE	B AE R IY M AO R
BARRYMORE(2)	B EH R IY M AO R
BARTY	B AA R T IY
BASE	B EY S
BASEBALL	B EY S B AO L
BASED	B EY S T
BASEMENT	B EY S M AH N T
BASHING	B AE SH IH NG
BASICALLY	B EY S IH K L IY
BASING	B EY S IH NG
BASIS	B EY S AH S
BASIS(2)	B EY S IH S
BASKET	B AE S K AH T
BAT	B AE T
BATHROOM	B AE TH R UW M
BATTLE	B AE T AH L
BAUREL	B AO R AH L
BAVA	B AA V AH
BAWDY	B AO D IY
BE	B IY
BEAMED	B IY M D
BEAST	B IY S T
BEATTY	B IY T IY
BEATTY(2)	B EY T IY
BEAUTIFUL	B Y UW T AH F AH L
BEAUTIFULLY	B Y UW T AH F L IY
BEAUTY	B Y UW T IY
BECAME	B IH K EY M
BECAME(2)	B IY K EY M
BECAUSE	B IH K AO Z
BECAUSE(2)	B IH K AH Z
BECAUSE(3)	B IH K AA Z
BECKINSALE	B EH K IH N S EY L
BECKY	B EH K IY
BECOME	B IH K AH M
BECOMES	B IH K AH M Z
BECOMING	B IH K AH M IH NG
BEDROOM	B EH D R UW M
BEECH	B IY CH
BEEN	B IH N
BEEN(2)	B AH N
BEFORE	B IH F AO R
BEFORE(2)	B IY F AO R
BEFRIENDS	B IH F R EH N D Z
BEGAN	B IH G AE N
BEGAN(2)	B IY G AE N
BEGIN	B IH G IH N
BEGINNING	B IH G IH N IH NG
BEGINS	B IH G IH N Z
BEHAVIOR	B IH HH EY V Y ER
BEHIND	B IH HH AY N D
BEING	B IY IH NG
BEINGS	B IY IH NG Z
BELIEFS	B IH L IY F S
BELIEVABLE	B AH L IY V AH B AH L
BELIEVE	B IH L IY V
BELIEVED	B IH L IY V D
BELL	B EH L
BELUSHI	B EH L UW SH IY
BEN	B EH N
BENARD	B IH N AA R D
BENDING	B EH N D IH NG
BENEATH	B IH N IY TH
BENEFIT	B EH N AH F IH T
BENJAMIN	B EH N JH AH M AH N
BERLIN	B ER L IH N
BERNIE	B ER N IY
BERRY	B EH R IY
BERSERK	B ER S ER K
BEST	B EH S T
BETTER	B EH T ER
BETWEEN	B IH T W IY N
BETWEEN(2)	B IY T W IY N
BEYOND	B IH AA N D
BEYOND(2)	B IY AO N D
BEYOND(3)	B IH AO N D
BI	B AY
BIASED	B AY AH S T
BIBI	B IH B IY
BIBI(2)	B IY B IY
BIG	B IH G
BIGGER	B IH G ER
BIGGEST	B IH G AH S T
BILL	B IH L
BILLIE	B IH L IY
BILLY	B IH L IY
BINDER	B AY N D ER
BINDING	B AY N D IH NG
BIRTH	B ER TH
BIRTHDAY	B ER TH D EY
BIT	B IH T
BITCHY	B IH CH IY
BIZARRE	B AH Z AA R
BIZARRE(2)	B IH Z AA R
BLACK	B L AE K
BLADE	B L EY D
BLAME	B L EY M
BLAMES	B L EY M Z
BLANKS	B L AE NG K S
BLAXPLOITATION	B L AE K S L OY T EY SH AH N
BLEW	B L UW
BLOOD	B L AH D
BLOODLUST	B L AH D L AH S T
BLOODY	B L AH D IY
BLOW	B L OW
BLOWING	B L OW IH NG
BLOWN	B L OW N
BLUE	B L UW
BOASTS	B OW S T S
BOAT	B OW T
BOB	B AA B
BOBBY	B AA B IY
BODIES	B AA D IY Z
BODYGUARD	B AA D IY G AA R D
BOGGLING	B AA G AH L IH NG
BOGGLING(2)	B AA G L IH NG
BOGOSIAN	B AH G AA ZH IH N
BOLLYWOOD	B AO L IH W UH D
BOMBASTIC	B AA M B AE S T IH K
BOMBED	B AA M D
BOND	B AA N D
BONES	B OW N Z
BOOGIE	B UW G IY
BOOGIE(2)	B UH G IY
BOOK	B UH K
BOOKS	B UH K S
BOORMAN	B UH R M AH N
BORDER	B AO R D ER
BORE	B AO R
BOREANAZ	B AH R IY N AH Z
BORING	B AO R IH NG
BORNE	B AO R N
BOSS	B AA S
BOSS(2)	B AO S
BOSWELL	B AA Z W EH L
BOTH	B OW TH
BOTHERS	B AA DH ER Z
BOTTLE	B AA T AH L
BOTTOM	B AA T AH M
BOTTOMS	B AA T AH M Z
BOUGHT	B AA T
BOUGHT(2)	B AO T
BOULEVARDIER	B UH L AH V AA R D IY ER
BOUND	B AW N D
BOWELS	B AW AH L Z
BOWELS(2)	B AW L Z
BOX	B AA K S
BOXER	B AA K S ER
BOY	B OY
BOYLE	B OY L
BOYS	B OY Z
BRAINY	B R EY N IY
BRANAGH	B R AE N AH G
BRANDO	B R AE N D OW
BRAT	B R AE T
BRAZIL	B R AH Z IH L
BREAK	B R EY K
BREAKDOWN	B R EY K D AW N
BREAKER	B R EY K ER
BREAKOUT	B R EY K AW T
BREAKS	B R EY K S
BREATH	B R EH TH
BREATHING	B R IY DH IH NG
BREATHLESS	B R EH TH L AH S
BRIBES	B R AY B Z
BRIDGE	B R IH JH
BRIGHT	B R AY T
BRILLANT	B R IH L AH N T
BRILLIANCE	B R IH L Y AH N S
BRILLIANT	B R IH L Y AH N T
BRILLIANTLY	B R IH L Y AH N T L IY
BRING	B R IH NG
BRINGS	B R IH NG Z
BRISSON	B R IH S AH N
BRITISH	B R IH T IH SH
BROADWAY	B R AO D W EY
BROKEN	B R OW K AH N
BROKERS	B R OW K ER Z
BRONSTEIN	B R AA N S T IY N
BRONSTEIN(2)	B R AA N S T AY N
BROODING	B R UW D IH NG
BROTHER	B R AH DH ER
BROTHERS	B R AH DH ER Z
BROUGHT	B R AO T
BROWN	B R AW N
BRUHL	B R AH L
BRUTAL	B R UW T AH L
BRUTALLY	B R UW T AH L IY
BUCKET	B AH K IH T
BUCKETS	B AH K AH T S
BUCKS	B AH K S
BUDDIES	B AH D IY Z
BUDDY	B AH D IY
BUDGET	B AH JH IH T
BUILD	B IH L D
BUILDING	B IH L D IH NG
BUILDINGS	B IH L D IH NG Z
BUILT	B IH L T
BULK	B AH L K
BULL	B UH L
BUNCH	B AH N CH
BURIED	B EH R IY D
BURROWS	B ER OW Z
BURT	B ER T
BUSHMAN	B UH SH M AH N
BUSINESS	B IH Z N AH S
BUSINESS(2)	B IH Z N IH S
BUSY	B IH Z IY
BUT	B AH T
BUY	B AY
BUYS	B AY Z
BY	B AY
BYRDS	B AH R D Z
BYRON	B AY R AH N
C	S IY
CABAL	K AH B AA L
CADET	K AH D EH T
CAGE	K EY JH
CAGNEY	K AE G N IY
CAHULAWASSEEÂ…	K AE HH Y UW L AH AH S IY IY
CAINE	K EY N
CALAMITIES	K AH L AE M AH T IY Z
CALCULATING	K AE L K Y AH L EY T IH NG
CALENDER	K AH L EH N D AH R
CALIBER	K AE L AH B ER
CALL	K AO L
CALLED	K AO L D
CAME	K EY M
CAMEO	K AE M IY OW
CAMERA	K AE M ER AH
CAMERA(2)	K AE M R AH
CAMP	K AE M P
CAMPY	K AE M P IY
CAN	K AE N
CAN(2)	K AH N
CANADIAN	K AH N EY D IY AH N
CANDIDATES	K AE N D AH D EY T S
CANDIDATES(2)	K AE N AH D IH T S
CANDY	K AE N D IY
CANNON	K AE N AH N
CANNOT	K AE N AA T
CANNOT(2)	K AH N AA T
CANVAS	K AE N V AH S
CAPITALIZES	K AE P AH T AH L AY Z IH Z
CAPSULE	K AE P S AH L
CAPTORS	K AE P T ER Z
CAPTURE	K AE P CH ER
CAPTURED	K AE P CH ER D
CAPTURES	K AE P CH ER Z
CAR	K AA R
CARA	K EH R AH
CARDS	K AA R D Z
CARE	K EH R
CAREER	K ER IH R
CAREFUL	K EH R F AH L
CAREFULLY	K EH R F AH L IY
CARES	K EH R Z
CAREY	K EH R IY
CARHART	K AA R HH AA R T
CARL	K AA R L
CARNIVAL	K AA R N AH V AH L
CARON	K AA R AO N
CARR	K AA R
CARRIED	K AE R IY D
CARRIED(2)	K EH R IY D
CARRIES	K AE R IY Z
CARRIES(2)	K EH R IY Z
CARRYING	K AE R IY IH NG
CARRYING(2)	K EH R IY IH NG
CARS	K AA R Z
CARS(2)	K AA Z
CARTOONS	K AA R T UW N Z
CASA	K AA S AH
CASE	K EY S
CAST	K AE S T
CASTING	K AE S T IH NG
CASTLE	K AE S AH L
CATALOG	K AE T AH L AO G
CATALYZING	K EY T AH L IY Z IH NG
CATCH	K AE CH
CATCHY	K AE CH IY
CATEGORISE	K AE T IY G OW R AY Z
CAUGHT	K AA T
CAUGHT(2)	K AO T
CAUSE	K AA Z
CAUSE(2)	K AO Z
CAUSED	K AA Z D
CAUSED(2)	K AO Z D
CB	S IY B
CECIL	S IY S AH L
CEDRIC	S EH D R IH K
CEDRIC(2)	S IY D R IH K
CELEBRATED	S EH L AH B R EY T IH D
CEMETERY	S EH M AH T EH R IY
CEMETERY(2)	S EH M IH T EH R IY
CENTER	S EH N T ER
CENTER(2)	S EH N ER
CENTERED	S EH N T ER D
CENTRAL	S EH N T R AH L
CENTS	S EH N T S
CENTS(2)	S EH N S
CENTURY	S EH N CH ER IY
CEREBRAL	S EH R AH B R AH L
CEREBRAL(2)	S ER IY B R AH L
CERTAIN	S ER T AH N
CERTAINLY	S ER T AH N L IY
CG	S IY G
CHAIRMAN	CH EH R M AH N
CHAIRS	CH EH R Z
CHALK	CH AA K
CHALK(2)	CH AO K
CHALLENGING	CH AE L AH N JH IH NG
CHAMAS	CH AE M AH Z
CHANCE	CH AE N S
CHANGE	CH EY N JH
CHANGED	CH EY N JH D
CHANGES	CH EY N JH AH Z
CHANGES(2)	CH EY N JH IH Z
CHANGING	CH EY N JH IH NG
CHANNEL	CH AE N AH L
CHARACTER	K EH R IH K T ER
CHARACTERISATIONS	K AE R IH K T ER IY Z EY SH AH N Z
CHARACTERIZATION	K EH R IH K T ER IH Z EY SH AH N
CHARACTERIZE	K EH R IH K T ER AY Z
CHARACTERIZED	K EH R IH K T ER AY Z D
CHARACTERS	K AE R IH K T ER Z
CHARACTERS(2)	K EH R IH K T ER Z
CHAREL	CH AE R AH L
CHARGED	CH AA R JH D
CHARITY	CH EH R IH T IY
CHARLES	CH AA R L Z
CHARLES(2)	CH AA R AH L Z
CHARLEY	CH AA R L IY
CHARM	CH AA R M
CHARTS	CH AA R T S
CHASE	CH EY S
CHASES	CH EY S AH Z
CHASES(2)	CH EY S IH Z
CHAVALIER	CH AH V AE L AY AH R
CHAVEZ	SH AA V EH Z
CHAVEZ(2)	CH AE V EH Z
CHAVEZ(3)	SH AH V EH Z
CHEADLE	CH IY D AH L
CHEAP	CH IY P
CHECK	CH EH K
CHECKED	CH EH K T
CHEEK	CH IY K
CHEER	CH IH R
CHEERLEADER	CH IH R L IY D ER
CHEESE	CH IY Z
CHEESECAKE	CH IY Z K EY K
CHEESINESS	CH IY Z IY N AH S
CHEESY	CH IY Z IY
CHEEZY	CH IY Z IY
CHEMISTRY	K EH M IH S T R IY
CHIAURELI	CH AY AH UH R AH L IY
CHILD	CH AY L D
CHILDHOOD	CH AY L D HH UH D
CHILDLIKE	CH AY L D L AY K
CHILDREN	CH IH L D R AH N
CHILLING	CH IH L IH NG
CHILLS	CH IH L Z
CHINESE	CH AY N IY Z
CHIP	CH IH P
CHOCOLATE	CH AO K L AH T
CHOICE	CH OY S
CHOOSE	CH UW Z
CHOPPILY	CH AA P IY L IY
CHORUS	K AO R AH S
CHOSEN	CH OW Z AH N
CHRISTINA	K R IH S T IY N AH
CHRISTINE	K R IH S T IY N
CHRISTOPHER	K R IH S T AH F ER
CHRONICLES	K R AA N IH K AH L Z
CHUCK	CH AH K
CHUNKS	CH AH NG K S
CHURCH	CH ER CH
CHURCHILL	CH ER CH IH L
CHURCHILL(2)	CH ER CH HH IH L
CIA	S IY AY EY
CIARIN	S AY AH R AH N
CINDERELLA	S IH N D ER EH L AH
CINEMA	S IH N AH M AH
CINEMATIC	S IH N AH M AE T IH K
CINEMATOGRAPHY	S IH N IH M AH T AA G R AH F IY
CIRCLE	S ER K AH L
CITIES	S IH T IY Z
CITIZEN	S IH T AH Z AH N
CITIZEN(2)	S IH T IH Z AH N
CITIZENS	S IH T AH Z AH N Z
CITIZENS(2)	S IH T IH Z AH N Z
CITY	S IH T IY
CIVILIZED	S IH V AH L AY Z D
CLARKE	K L AA R K
CLASS	K L AE S
CLASSIC	K L AE S IH K
CLASSICS	K L AE S IH K S
CLEAN	K L IY N
CLEANING	K L IY N IH NG
CLEAR	K L IH R
CLEARENCE	K L IH ER AH N S
CLEARLY	K L IH R L IY
CLEEF	K L IY F
CLEVELAND	K L IY V L AH N D
CLEVER	K L EH V ER
CLEVERLY	K L EH V ER L IY
CLICHE	K L IY SH EY
CLICHÃ©	K L IH CH
CLICHÃ©D	K L IH CH D
CLICHÃ©S	K L IH CH S
CLICK	K L IH K
CLIFF	K L IH F
CLIFFORD	K L IH F ER D
CLIMACTIC	K L AY M AE K T IH K
CLIMBS	K L AY M Z
CLINT	K L IH N T
CLIPPED	K L IH P T
CLIPS	K L IH P S
CLOCK	K L AA K
CLOSE	K L OW S
CLOSE(2)	K L OW Z
CLOSELY	K L OW S L IY
CLOSING	K L OW Z IH NG
CLOSURE	K L OW ZH ER
CLOUDS	K L AW D Z
CLOWN	K L AW N
CLUB	K L AH B
CLUBS	K L AH B Z
CLUES	K L UW Z
CLUTTERED	K L AH T ER D
CODE	K OW D
COLD	K OW L D
COLLEGE	K AA L IH JH
COLLETTE	K AH L EH T
COLONY	K AA L AH N IY
COLORIZATION	K AH L ER AH Z EY SH AH N
COLORS	K AH L ER Z
COLOURS	K AH L ER Z
COLUMBINE	K AA L AH M B AY N
COLUMN	K AA L AH M
COM	K AA M
COMBINATION	K AA M B AH N EY SH AH N
COME	K AH M
COMEBACK	K AH M B AE K
COMEDIC	K AH M IY D IH K
COMEDIES	K AA M AH D IY Z
COMEDY	K AA M AH D IY
COMES	K AH M Z
COMFORTED	K AH M F ER T IH D
COMIC	K AA M IH K
COMICAL	K AA M IH K AH L
COMING	K AH M IH NG
COMMANDING	K AH M AE N D IH NG
COMMENT	K AA M EH N T
COMMENTARY	K AA M AH N T EH R IY
COMMENTATOR	K AA M AH N T EY T ER
COMMENTED	K AA M EH N T AH D
COMMENTING	K AA M EH N T IH NG
COMMIT	K AH M IH T
COMMON	K AA M AH N
COMPANY	K AH M P AH N IY
COMPARED	K AH M P EH R D
COMPELLING	K AH M P EH L IH NG
COMPETENT	K AA M P AH T IH N T
COMPILATION	K AA M P AH L EY SH AH N
COMPLAINT	K AH M P L EY N T
COMPLETE	K AH M P L IY T
COMPLETELY	K AH M P L IY T L IY
COMPLEX	K AA M P L EH K S
COMPLEX(2)	K AH M P L EH K S
COMPLICATED	K AA M P L AH K EY T AH D
COMPLICATION	K AA M P L AH K EY SH AH N
COMPOSED	K AH M P OW Z D
COMPOSER	K AH M P OW Z ER
COMPOSERS	K AH M P OW Z ER Z
COMPOUND	K AA M P AW N D
COMPOUND(2)	K AH M P AW N D
CONCEITED	K AH N S IY T AH D
CONCENTRATED	K AA N S AH N T R EY T AH D
CONCENTRATED(2)	K AO N S AH N T R EY T IH D
CONCENTRATES	K AA N S AH N T R EY T S
CONCERN	K AH N S ER N
CONCERNS	K AH N S ER N Z
CONCLUDE	K AH N K L UW D
CONCLUDED	K AH N K L UW D AH D
CONCLUDED(2)	K AH N K L UW D IH D
CONCLUSION	K AH N K L UW ZH AH N
CONDENSING	K AH N D EH N S IH NG
CONDITION	K AH N D IH SH AH N
CONDUCTED	K AH N D AH K T AH D
CONFIDENCE	K AA N F AH D EH N S
CONFRONT	K AH N F R AH N T
CONFRONTING	K AH N F R AH N T IH NG
CONFUSED	K AH N F Y UW Z D
CONFUSING	K AH N F Y UW Z IH NG
CONJUNCTIVITIS	K AH N JH AH NG K T IH V AH T IY Z
CONNERY	K AA N ER IY
CONSEQUENCE	K AA N S AH K W AH N S
CONSERVATIVE	K AH N S ER V AH T IH V
CONSIDER	K AH N S IH D ER
CONSIDERED	K AH N S IH D ER D
CONSIDERING	K AH N S IH D ER IH NG
CONSIDERS	K AH N S IH D ER Z
CONSISTS	K AH N S IH S T S
CONSTANTLY	K AA N S T AH N T L IY
CONSTRUCTION	K AH N S T R AH K SH AH N
CONSULATE	K AA N S AH L AH T
CONTAINING	K AH N T EY N IH NG
CONTAINS	K AH N T EY N Z
CONTENT	K AA N T EH N T
CONTENT(2)	K AH N T EH N T
CONTEST	K AA N T EH S T
CONTEST(2)	K AH N T EH S T
CONTEXTUAL	K AA N T EH K S CH UW AH L
CONTINUED	K AH N T IH N Y UW D
CONTINUITY	K AA N T AH N UW AH T IY
CONTRARY	K AA N T R EH R IY
CONTRARY(2)	K AH N T R EH R IY
CONTRAST	K AA N T R AE S T
CONTRAST(2)	K AH N T R AE S T
CONTRIBUTIONS	K AA N T R AH B Y UW SH AH N Z
CONTRIVED	K AH N T R AY V D
CONTROL	K AH N T R OW L
CONTROVERSY	K AA N T R AH V ER S IY
CONVENTION	K AH N V EH N SH AH N
CONVENTIONAL	K AH N V EH N SH AH N AH L
CONVENTIONALLY	K AH N V EH N SH AH N AH L IY
CONVENTIONS	K AH N V EH N SH AH N Z
CONVEY	K AH N V EY
CONVEYED	K AH N V EY D
CONVICTED	K AH N V IH K T AH D
COOKED	K UH K T
COOKIE	K UH K IY
COOL	K UW L
COP	K AA P
COPY	K AA P IY
CORE	K AO R
CORMAN	K AO R M AH N
CORNY	K AO R N IY
CORPORATE	K AO R P ER AH T
CORPORATE(2)	K AO R P R AH T
CORRECT	K ER EH K T
COST	K AA S T
COST(2)	K AO S T
COSTLY	K AA S T L IY
COSTLY(2)	K AO S T L IY
COSTUMES	K AA S T UW M Z
COSTUMING	K AA S T UW M IH NG
COULD	K UH D
COULDN	K OW AH L D N
COUNTEROFFER	K AW N T ER AO F ER
COUNTING	K AW N T IH NG
COUNTRIES	K AH N T R IY Z
COUNTRY	K AH N T R IY
COUNTRYSIDE	K AH N T R IY S AY D
COUPLE	K AH P AH L
COUPLED	K AH P AH L D
COUPS	K UW Z
COURAGEOUS	K ER EY JH AH S
COURSE	K AO R S
COURT	K AO R T
COURTESAN	K OW R T AH S AH N
COURTNEY	K AO R T N IY
COURTROOM	K AO R T R UW M
COVER	K AH V ER
COWORKER	K OW W ER K ER
COWORKERS	K OW W ER K ER Z
COX	K AA K S
CRADLE	K R EY D AH L
CRAFTING	K R AE F T IH NG
CRAIG	K R EY G
CRAP	K R AE P
CRAPPY	K R AE P IY
CRASH	K R AE SH
CRAZED	K R EY Z D
CRAZY	K R EY Z IY
CREAMED	K R IY M D
CREASEY	K R IY S IY
CREASY	K R IY S IY
CREATE	K R IY EY T
CREATED	K R IY EY T AH D
CREATED(2)	K R IY EY T IH D
CREATING	K R IY EY T IH NG
CREATORS	K R IY EY T ER Z
CREATURE	K R IY CH ER
CREDIT	K R EH D AH T
CREDIT(2)	K R EH D IH T
CREEPY	K R IY P IY
CREW	K R UW
CRIED	K R AY D
CRIME	K R AY M
CRIMES	K R AY M Z
CRIMINAL	K R IH M AH N AH L
CRIMINALS	K R IH M AH N AH L Z
CRIPPLED	K R IH P AH L D
CRISIS	K R AY S AH S
CRISP	K R IH S P
CRISTY	K R IH S T IY
CRITIC	K R IH T IH K
CRITICISE	K R IH T AH S AY Z
CRITICISM	K R IH T IH S IH Z AH M
CRITICISMS	K R IH T IH S IH Z AH M Z
CRITICS	K R IH T IH K S
CROWD	K R AW D
CRUCIAL	K R UW SH AH L
CRUEL	K R UW AH L
CRUEL(2)	K R UW L
CRY	K R AY
CRYING	K R AY IH NG
CRYPTIC	K R IH P T IH K
CUBE	K Y UW B
CULT	K AH L T
CULTURAL	K AH L CH ER AH L
CULTURE	K AH L CH ER
CUP	K AH P
CURED	K Y UH R D
CURSE	K ER S
CURTAIN	K ER T AH N
CURTIS	K ER T AH S
CURTIS(2)	K ER T IH S
CUT	K AH T
CUTE	K Y UW T
CUTESY	K Y UW T S IY
CUTTER	K AH T ER
CUTTING	K AH T IH NG
CYCLOPS	S AY K L AO P S
CYNICAL	S IH N IH K AH L
D	D IY
DA	D AA
DA(2)	D IY EY
DAILY	D EY L IY
DAISIES	D EY Z IY Z
DAISY	D EY Z IY
DAKOTA	D AH K OW T AH
DALE	D EY L
DALLAS	D AE L AH S
DALTON	D AO L T AH N
DAM	D AE M
DAMN	D AE M
DAN	D AE N
DANCE	D AE N S
DANCER	D AE N S ER
DANCERS	D AE N S ER Z
DANCING	D AE N S IH NG
DANDY	D AE N D IY
DANELIA	D AH N IY L Y AH
DANGER	D EY N JH ER
DANGEROUS	D EY N JH ER AH S
DANGERS	D EY N JH ER Z
DANIEL	D AE N Y AH L
DANTE	D AA N T EY
DAOSHVILI	D EY AA SH V AH L IY
DARE	D EH R
DARES	D EH R Z
DARK	D AA R K
DARLENE	D AA R L IY N
DATE	D EY T
DATED	D EY T IH D
DAUGHTER	D AO T ER
DAVID	D EY V IH D
DAVIS	D EY V AH S
DAVIS(2)	D EY V IH S
DAWN	D AO N
DAY	D EY
DAYS	D EY Z
DC	D IY S IY
DE	D IY
DE(2)	D EY
DE(3)	D AH
DEAD	D EH D
DEAF	D EH F
DEAL	D IY L
DEALER	D IY L ER
DEALERS	D IY L ER Z
DEALING	D IY L IH NG
DEALS	D IY L Z
DEALT	D EH L T
DEATH	D EH TH
DEATHTRAP	D EH TH T R AE P
DECADE	D EH K EY D
DECADENT	D EH K AH D AH N T
DECADES	D EH K EY D Z
DECEASED	D IH S IY S T
DECEIVE	D IH S IY V
DECEIVED	D IH S IY V D
DECENCY	D IY S AH N S IY
DECENT	D IY S AH N T
DECEPTIVE	D IH S EH P T IH V
DECIDE	D IH S AY D
DECIDED	D IH S AY D IH D
DECIDES	D IH S AY D Z
DECK	D EH K
DEDICATED	D EH D AH K EY T AH D
DEEP	D IY P
DEEPER	D IY P ER
DEFEAT	D IH F IY T
DEFENDING	D IH F EH N D IH NG
DEFINATELY	D IH F AY N AH T L IY
DEFINED	D IH F AY N D
DEFINITELY	D EH F AH N AH T L IY
DELIBERATE	D IH L IH B ER AH T
DELIBERATE(2)	D IH L IH B ER EY T
DELIBERATE(3)	D IH L IH B R AH T
DELIBERATELY	D IH L IH B ER AH T L IY
DELIBERATELY(2)	D IH L IH B R AH T L IY
DELIGHTED	D IH L AY T AH D
DELIGHTED(2)	D IH L AY T IH D
DELIGHTFUL	D IH L AY T F AH L
DELIVER	D IH L IH V ER
DELIVERANCE	D IH L IH V ER AH N S
DELIVERANCE(2)	D IH L IH V R AH N S
DELIVERED	D IH L IH V ER D
DELIVERING	D IH L IH V ER IH NG
DELIVERY	D IH L IH V ER IY
DELL	D EH L
DEMAND	D IH M AE N D
DEMANDING	D IH M AE N D IH NG
DEMON	D IY M AH N
DEMONIC	D IH M AA N IH K
DEMONS	D IY M AH N Z
DEMONSTRATE	D EH M AH N S T R EY T
DENMARK	D EH N M AA R K
DENNIS	D EH N IH S
DENSITY	D EH N S AH T IY
DENSITY(2)	D EH N S IH T IY
DENZEL	D EH N Z AH L
DEPICT	D IH P IH K T
DEPRESSED	D IH P R EH S T
DEPT	D EH P T
DEPTH	D EH P TH
DEPUTY	D EH P Y AH T IY
DEPUTY(2)	D EH P Y UW T IY
DERANGEMENT	D IY R EY N JH M AH N T
DESCENT	D IH S EH N T
DESCRIBED	D IH S K R AY B D
DESECRATED	D EH Z AH K R EY T IH D
DESECRATED(2)	D EH S AH K R EY T IH D
DESERT	D EH Z ER T
DESERT(2)	D IH Z ER T
DESERTED	D IH Z ER T IH D
DESERVE	D IH Z ER V
DESERVED	D IH Z ER V D
DESERVES	D IH Z ER V Z
DESIGNED	D IH Z AY N D
DESOLATE	D EH S AH L AH T
DESOLATE(2)	D EH Z AH L AH T
DESOLATE(3)	D EH S AH L EY T
DESPISED	D IH S P AY Z D
DESPITE	D IH S P AY T
DESTINY	D EH S T AH N IY
DESTRUCTION	D IH S T R AH K SH AH N
DETACHED	D IH T AE CH T
DETACHED(2)	D IY T AE CH T
DETAIL	D IH T EY L
DETAIL(2)	D IY T EY L
DETAILED	D IH T EY L D
DETAILS	D IH T EY L Z
DETAILS(2)	D IY T EY L Z
DETECTIVE	D IH T EH K T IH V
DETERIORATION	D IH T IH R IY ER EY SH AH N
DETERRED	D IH T ER D
DETRACT	D IH T R AE K T
DETROIT	D IH T R OY T
DETROIT(2)	D IY T R OY T
DEVELOPED	D IH V EH L AH P T
DEVELOPER	D IH V EH L AH P ER
DEVELOPING	D IH V EH L AH P IH NG
DEVELOPMENT	D IH V EH L AH P M AH N T
DEVELOPMENTS	D IH V EH L AH P M AH N T S
DEVELOPS	D IH V EH L AH P S
DEVICES	D IH V AY S AH Z
DEVICES(2)	D IH V AY S IH Z
DIALOG	D AY AH L AO G
DIALOGUE	D AY AH L AO G
DIAMOND	D AY M AH N D
DICK	D IH K
DICTATORSHIP	D IH K T EY T ER SH IH P
DID	D IH D
DIDN	D IH D N
DIE	D AY
DIED	D AY D
DIES	D AY Z
DIFFERENCE	D IH F ER AH N S
DIFFERENCE(2)	D IH F R AH N S
DIFFERENT	D IH F ER AH N T
DIFFERENT(2)	D IH F R AH N T
DIFFERS	D IH F ER Z
DIFFICULT	D IH F AH K AH L T
DIGGERS	D IH G ER Z
DIGGING	D IH G IH NG
DIME	D AY M
DIMENSION	D IH M EH N SH AH N
DIMENSIONAL	D IH M EH N SH AH N AH L
DIMINISH	D IH M IH N IH SH
DINER	D AY N ER
DIRECTED	D ER EH K T AH D
DIRECTED(2)	D ER EH K T IH D
DIRECTED(3)	D AY R EH K T IH D
DIRECTED(4)	D IH R EH K T IH D
DIRECTING	D ER EH K T IH NG
DIRECTING(2)	D IY R EH K T IH NG
DIRECTING(3)	D AY R EH K T IH NG
DIRECTING(4)	D IH R EH K T IH NG
DIRECTION	D ER EH K SH AH N
DIRECTION(2)	D IY R EH K SH IH N
DIRECTION(3)	D AY R EH K SH IH N
DIRECTION(4)	D IH R EH K SH IH N
DIRECTOR	D ER EH K T ER
DIRECTOR(2)	D AY R EH K T ER
DIRECTOR(3)	D IY R EH K T ER
DIRECTOR(4)	D IH R EH K T ER
DIRECTORIAL	D ER EH K T AO R IY AH L
DIRECTORIAL(2)	D AY R EH K T AO R IY AH L
DIRECTORIAL(3)	D IY R EH K T AO R IY AH L
DIRECTORIAL(4)	D IH R EH K T AO R IY AH L
DIRECTORS	D ER EH K T ER Z
DIRECTORS(2)	D AY R EH K T ER Z
DIRECTORS(3)	D IY R EH K T ER Z
DIRECTORS(4)	D IH R EH K T ER Z
DIRECTS	D ER EH K T S
DIRECTS(2)	D AY R EH K T S
DIRECTS(3)	D IY R EH K T S
DIRECTS(4)	D IH R EH K T S
DISAGREE	D IH S AH G R IY
DISAPPEAR	D IH S AH P IH R
DISAPPEAR(2)	D IH S AH P IY R
DISAPPEARED	D IH S AH P IH R D
DISAPPEARED(2)	D IH S AH P IY R D
DISAPPEARS	D IH S AH P IH R Z
DISAPPEARS(2)	D IH S AH P IY R Z
DISAPPOINT	D IH S AH P OY N T
DISAPPOINTED	D IH S AH P OY N T IH D
DISAPPOINTED(2)	D IH S AH P OY N IH D
DISARMING	D IH S AA R M IH NG
DISASTER	D IH Z AE S T ER
DISASTERS	D IH Z AE S T ER Z
DISASTROUS	D IH Z AE S T R AH S
DISCO	D IH S K OW
DISCONNECTED	D IH S K AH N EH K T IH D
DISCONTINUE	D IH S K AH N T IH N Y UW
DISCOVER	D IH S K AH V ER
DISCUSS	D IH S K AH S
DISCUSSING	D IH S K AH S IH NG
DISEASE	D IH Z IY Z
DISEASES	D IH Z IY Z AH Z
DISEASES(2)	D IH Z IY Z IH Z
DISENFRANCHISED	D IH S IH N F R AE N CH AY Z D
DISLIKE	D IH S L AY K
DISMAL	D IH Z M AH L
DISNEY	D IH Z N IY
DISPLAY	D IH S P L EY
DISTANCE	D IH S T AH N S
DISTRESSED	D IH S T R EH S T
DISTRICTS	D IH S T R IH K T S
DISTURBED	D IH S T ER B D
DISTURBING	D IH S T ER B IH NG
DIVERGENT	D AY V ER JH AH N T
DIVERGENT(2)	D IH V ER JH AH N T
DJ	D IY JH
DJAFARIDZE	JH AE F AH R AH D Z
DO	D UW
DOCTOR	D AA K T ER
DOCTOR(2)	D AO K T ER
DOCTRINES	D AA K T R AH N Z
DOCUMENTARIES	D AA K Y AH M EH N T ER IY Z
DOCUMENTARIES(2)	D AA K Y AH M EH N ER IY Z
DOCUMENTARIES(3)	D AA K Y UW M EH N T ER IY Z
DOCUMENTARIES(4)	D AA K Y UW M EH N ER IY Z
DOCUMENTARY	D AA K Y AH M EH N T ER IY
DOCUMENTARY(2)	D AA K Y AH M EH N ER IY
DOCUMENTARY(3)	D AA K Y UW M EH N T ER IY
DOCUMENTARY(4)	D AA K Y UW M EH N ER IY
DODGY	D AA JH IY
DODO	D OW D OW
DOES	D AH Z
DOES(2)	D IH Z
DOESN	D OW AH Z N
DOG	D AO G
DOING	D UW IH NG
DON	D AA N
DONE	D AH N
DOOLEY	D UW L IY
DOOR	D AO R
DOORS	D AO R Z
DOPPELGANGER	D AA P EH L G AH NG AH R
DOUBLE	D AH B AH L
DOUBT	D AW T
DOUBTS	D AW T S
DOWN	D AW N
DOWNSIDE	D AW N S AY D
DOZEN	D AH Z AH N
DOZENS	D AH Z AH N Z
DRAG	D R AE G
DRAGON	D R AE G AH N
DRAMA	D R AA M AH
DRAMAS	D R AA M AH Z
DRAMATIC	D R AH M AE T IH K
DRASTICALLY	D R AE S T IH K L IY
DREAMLIKE	D R IY M L AY K
DRESS	D R EH S
DRESSED	D R EH S T
DRESSES	D R EH S AH Z
DRESSES(2)	D R EH S IH Z
DREW	D R UW
DREWS	D R UW Z
DRIFTER	D R IH F T ER
DRILL	D R IH L
DRIVE	D R AY V
DRIVER	D R AY V ER
DRONE	D R OW N
DROPS	D R AA P S
DRUG	D R AH G
DRUNK	D R AH NG K
DRYER	D R AY ER
DUBBED	D AH B D
DUBBING	D AH B IH NG
DUCKTALES	D AH K T EY L Z
DUE	D UW
DUE(2)	D Y UW
DUG	D AH G
DULL	D AH L
DUMB	D AH M
DUNDEE	D AH N D IY
DURING	D UH R IH NG
DURING(2)	D Y UH R IH NG
DURING(3)	D ER IH NG
DUSK	D AH S K
DUSTIN	D AH S T IH N
DVD	D IY V IY D IY
DWELLERS	D W EH L ER Z
DWIGHT	D W AY T
DYAN	D AY AE N
DYING	D AY IH NG
DYLAN	D IH L AH N
DÃ©JÃ 	D IY JH EY
E	IY
EA	IY AH
EACH	IY CH
EAGERLY	IY G ER L IY
EARLIER	ER L IY ER
EARLIEST	ER L IY AH S T
EARLY	ER L IY
EARSHOT	IH R SH AA T
EARSHOT(2)	IY R SH AA T
EARTH	ER TH
EARTHLY	ER TH L IY
EASE	IY Z
EASIEST	IY Z IY AH S T
EASILY	IY Z AH L IY
EAST	IY S T
EASY	IY Z IY
EASYGOING	IY Z IY G OW IH NG
EATING	IY T IH NG
EAZY	IY Z IY
ECONOMY	IH K AA N AH M IY
ECONOMY(2)	IY K AA N AH M IY
ED	EH D
EDD	EH D
EDDY	EH D IY
EDGE	EH JH
EDITED	EH D AH T AH D
EDITED(2)	EH D IH T IH D
EDITING	EH D AH T IH NG
EDITING(2)	EH D IH T IH NG
EDITS	EH D IH T S
EDO	IY D OW
EDWARD	EH D W ER D
EFFECT	IH F EH K T
EFFECT(2)	IY F EH K T
EFFECT(3)	AH F EH K T
EFFECTIVE	IH F EH K T IH V
EFFECTIVE(2)	IY F EH K T IH V
EFFECTS	IH F EH K T S
EFFECTS(2)	IH F EH K S
EFFECTS(3)	IY F EH K T S
EFFECTS(4)	IY F EH K S
EFFORTS	EH F ER T S
EGGS	EH G Z
EGLANTINE	EH G L AH N T AY N
EGLIMATA	EH G L IH M AH T AH
EGO	IY G OW
EIGHTIES	EY T IY Z
EISENSTEIN	AY Z AH N S T AY N
EISENSTEIN(2)	AY Z AH N S T IY N
EITHER	IY DH ER
EITHER(2)	AY DH ER
ELDERLY	EH L D ER L IY
ELDEST	EH L D AH S T
ELECTED	IH L EH K T AH D
ELECTED(2)	IH L EH K T IH D
ELECTION	IH L EH K SH AH N
ELEMENTARY	EH L AH M EH N T R IY
ELEMENTARY(2)	EH L AH M EH N T ER R IY
ELEMENTARY(3)	EH L AH M EH N CH R IY
ELEMENTS	EH L AH M AH N T S
ELEVATES	EH L AH V EY T S
ELEVEN	IH L EH V AH N
ELEVEN(2)	IY L EH V AH N
ELITE	IH L IY T
ELITE(2)	EY L IY T
ELSE	EH L S
ELSEWHERE	EH L S W EH R
EMBARRASSED	IH M B EH R AH S T
EMBARRASSING	IH M B EH R AH S IH NG
EMERGED	IH M ER JH D
EMERGED(2)	IY M ER JH D
EMILIA	AH M IY L IY AH
EMINENT	EH M AH N AH N T
EMMA	EH M AH
EMOTION	IH M OW SH AH N
EMOTION(2)	IY M OW SH AH N
EMOTIONAL	IH M OW SH AH N AH L
EMOTIONAL(2)	IY M OW SH AH N AH L
EMOTIONALLY	IH M OW SH N AH L IY
EMOTIONALLY(2)	IY M OW SH N AH L IY
EMOTIONS	IH M OW SH AH N Z
EMOTIVE	IH M OW T IH V
EMOTIVE(2)	IY M OW T IH V
EMPHASIZE	EH M F AH S AY Z
EMPLOYER	EH M P L OY ER
EMPLOYER(2)	IH M P L OY ER
EMPLOYERS	EH M P L OY ER Z
EMPLOYERS(2)	IH M P L OY ER Z
EMULATE	EH M Y AH L EY T
EN	EH N
ENCHANTED	EH N CH AE N T IH D
ENCHANTED(2)	EH N CH AE N IH D
ENCOUNTER	IH N K AW N T ER
ENCOUNTER(2)	IH N K AW N ER
ENCOUNTERED	IH N K AW N T ER D
ENCOUNTERED(2)	IH N K AW N ER D
ENCOUNTERS	IH N K AW N T ER Z
ENCOUNTERS(2)	IH N K AW N ER Z
END	EH N D
ENDEAVORING	IH N D EH V ER IH NG
ENDEAVORING(2)	IH N D EH V R IH NG
ENDED	EH N D AH D
ENDED(2)	EH N D IH D
ENDING	EH N D IH NG
ENDINGS	EH N D IH NG Z
ENDLESS	EH N D L AH S
ENDS	EH N D Z
ENEMIES	EH N AH M IY Z
ENEMY	EH N AH M IY
ENFORCEMENT	EH N F AO R S M AH N T
ENGLAND	IH NG G L AH N D
ENGLISH	IH NG G L IH SH
ENGLISH(2)	IH NG L IH SH
ENGROSSED	IH N G R OW S T
ENGROSSING	IH N G R OW S IH NG
ENHANCING	EH N HH AE N S IH NG
ENJOY	EH N JH OY
ENJOYABLE	EH N JH OY AH B AH L
ENJOYED	EH N JH OY D
ENJOYS	EH N JH OY Z
ENOUGH	IH N AH F
ENOUGH(2)	IY N AH F
ENSEMBLE	AA N S AA M B AH L
ENSUES	IH N S UW Z
ENTER	EH N T ER
ENTER(2)	EH N ER
ENTERED	EH N T ER D
ENTERED(2)	EH N ER D
ENTERPRISE	EH N T ER P R AY Z
ENTERPRISE(2)	EH N ER P R AY Z
ENTERPRISING	EH N T ER P R AY Z IH NG
ENTERPRISING(2)	EH N ER P R AY Z IH NG
ENTERTAINED	EH N T ER T EY N D
ENTERTAINED(2)	EH N ER T EY N D
ENTERTAINING	EH N T ER T EY N IH NG
ENTERTAINING(2)	EH N ER T EY N IH NG
ENTERTAINMENT	EH N T ER T EY N M AH N T
ENTERTAINMENT(2)	EH N ER T EY N M AH N T
ENTHRALLING	IH N TH R AO L IH NG
ENTHUSIAST	EH N TH UW Z IY AE S T
ENTIRE	IH N T AY ER
ENTIRETY	IH N T AY ER T IY
ENTITY	EH N T AH T IY
ENTITY(2)	EH N T IH T IY
ENVY	EH N V IY
EPIC	EH P IH K
EPISODE	EH P IH S OW D
EPISODES	EH P IH S OW D Z
EQUAL	IY K W AH L
EQUALLY	IY K W AH L IY
EQUIPMENT	IH K W IH P M AH N T
EQUIVALENT	IH K W IH V AH L AH N T
ERA	EH R AH
ERA(2)	IH R AH
ERAS	IH R AH Z
ERIC	EH R IH K
EROS	IH R AA S
ESCALATING	EH S K AH L EY T IH NG
ESCAPE	IH S K EY P
ESCAPED	IH S K EY P T
ESCAPEES	IH S K EY P IY Z
ESCAPING	IH S K EY P IH NG
ESOTERICS	EH S AH T EH R IH K S
ESPECIAL	AH S P EH SH AH L
ESPECIALLY	AH S P EH SH L IY
ESPECIALLY(2)	AH S P EH SH AH L IY
ESSENCE	EH S AH N S
ESSENTIALLY	EH S EH N SH AH L IY
ESSENTIALLY(2)	IY S EH N SH AH L IY
EST	EH S T
ESTABLISH	IH S T AE B L IH SH
ESTATE	EH S T EY T
ESTES	EH S T IY Z
ESTHETICS	EH S TH EH T IH K S
ESTIMATE	EH S T AH M AH T
ESTIMATE(2)	EH S T AH M EY T
ETC	EH T S EH T ER AH
ETERNITY	IH T ER N AH T IY
ETERNITY(2)	IY T ER N AH T IY
EUROPE	Y UH R AH P
EVACUATE	IH V AE K Y AH EY T
EVACUATE(2)	IY V AE K Y AH EY T
EVACUATION	IH V AE K Y AH W EY SH AH N
EVACUATION(2)	IY V AE K Y AH W EY SH AH N
EVEN	IY V IH N
EVENT	IH V EH N T
EVENT(2)	IY V EH N T
EVENTS	IH V EH N T S
EVENTS(2)	IY V EH N T S
EVENTUALLY	IH V EH N CH AH W AH L IY
EVENTUALLY(2)	IH V EH N SH AH L IY
EVENTUALLY(3)	IY V EH N CH AH W AH L IY
EVENTUALLY(4)	IY V EH N SH AH L IY
EVER	EH V ER
EVERETT	EH V ER AH T
EVERETT(2)	EH V R AH T
EVERY	EH V ER IY
EVERY(2)	EH V R IY
EVERYDAY	EH V R IY D EY
EVERYMAN	EH V R IY M AH N
EVERYONE	EH V R IY W AH N
EVERYTHING	EH V R IY TH IH NG
EVERYWHERE	EH V R IY W EH R
EVERYWHERE(2)	EH V R IY HH W EH R
EVGENI	EH V AH N IY
EVIDENCED	EH V IH D AH N S T
EVIDENCES	EH V AH D AH N S AH Z
EVIL	IY V AH L
EVOLVED	IH V AA L V D
EVOLVED(2)	IY V AA L V D
EX	EH K S
EXACTLY	IH G Z AE K T L IY
EXAGGERATEDLY	IH G Z AE JH ER AH T AH D L IY
EXAMPLE	IH G Z AE M P AH L
EXAMPLES	IH G Z AE M P AH L Z
EXCEEDED	IH K S IY D AH D
EXCEEDED(2)	IH K S IY D IH D
EXCELLENCE	EH K S AH L AH N S
EXCELLENT	EH K S AH L AH N T
EXCELLENTLY	EH K S AH L AH N T L IY
EXCEPT	IH K S EH P T
EXCEPTIONS	IH K S EH P SH AH N Z
EXCHANGE	IH K S CH EY N JH
EXCITING	IH K S AY T IH NG
EXCLUSIVELY	IH K S K L UW S IH V L IY
EXILED	EH G Z AY L D
EXILED(2)	EH K S AY L D
EXISTENCE	EH G Z IH S T AH N S
EXISTENCE(2)	IH G Z IH S T AH N S
EXONERATED	IH G Z AA N ER EY T IH D
EXPANSIVE	IH K S P AE N S IH V
EXPECT	IH K S P EH K T
EXPECTATIONS	EH K S P EH K T EY SH AH N Z
EXPECTED	IH K S P EH K T AH D
EXPECTED(2)	IH K S P EH K T IH D
EXPECTING	IH K S P EH K T IH NG
EXPENSE	IH K S P EH N S
EXPENSIVE	IH K S P EH N S IH V
EXPERIENCED	IH K S P IH R IY AH N S T
EXPERIENCES	IH K S P IH R IY AH N S IH Z
EXPERT	EH K S P ER T
EXPERTLY	EH K S P ER T L IY
EXPLAIN	IH K S P L EY N
EXPLAINS	IH K S P L EY N Z
EXPLANATION	EH K S P L AH N EY SH AH N
EXPLODE	IH K S P L OW D
EXPLOITATION	EH K S P L OY T EY SH AH N
EXPLORATIONS	EH K S P L ER EY SH AH N Z
EXPLORATIONS(2)	EH K S P L AO R EY SH AH N Z
EXPLORED	IH K S P L AO R D
EXPLOSION	IH K S P L OW ZH AH N
EXPOSED	IH K S P OW Z D
EXPOSURES	IH K S P OW ZH ER Z
EXPRESSING	IH K S P R EH S IH NG
EXPRESSION	IH K S P R EH SH AH N
EXPRESSIONIST	IH K S P R EH SH AH N AH S T
EXQUISITELY	EH K S K W IH Z IH T L IY
EXTRA	EH K S T R AH
EXTRAS	EH K S T R AH Z
EXTRAVAGANT	EH K S T R AE V AH G AH N T
EXTREME	IH K S T R IY M
EXTREMELY	IH K S T R IY M L IY
EY	IY IY
EYE	AY
EYES	AY Z
EYRE	EH R
EYRED	EY R D
F	EH F
FACE	F EY S
FACED	F EY S T
FACILITY	F AH S IH L IH T IY
FACING	F EY S IH NG
FACT	F AE K T
FACTOR	F AE K T ER
FACTS	F AE K T S
FACTS(2)	F AE K S
FADE	F EY D
FADED	F EY D AH D
FADED(2)	F EY D IH D
FADING	F EY D IH NG
FADS	F AE D Z
FAHEY	F AE HH IY
FAILING	F EY L IH NG
FAILS	F EY L Z
FAILURE	F EY L Y ER
FAIR	F EH R
FAIRGROUND	F EH R G R AW N D
FAIRLY	F EH R L IY
FAIRY	F EH R IY
FAITH	F EY TH
FALL	F AO L
FALL(2)	F AA L
FALLING	F AA L IH NG
FALLON	F AE L AH N
FALLS	F AO L Z
FALSE	F AO L S
FAMILIAR	F AH M IH L Y ER
FAMILIES	F AE M AH L IY Z
FAMILIES(2)	F AE M L IY Z
FAMILY	F AE M AH L IY
FAMILY(2)	F AE M L IY
FAMOUS	F EY M AH S
FAN	F AE N
FANGIRL	F AE N G ER L
FANNING	F AE N IH NG
FANS	F AE N Z
FANTASIA	F AE N T EY ZH AH
FANTASTIC	F AE N T AE S T IH K
FANTASY	F AE N T AH S IY
FANTASY(2)	F AE N AH S IY
FAR	F AA R
FARING	F EH R IY NG
FASCINATING	F AE S AH N EY T IH NG
FASHION	F AE SH AH N
FASHIONS	F AE SH AH N Z
FAST	F AE S T
FATALE	F AE T EY L
FATE	F EY T
FATHER	F AA DH ER
FAULTS	F AO L T S
FAVORITE	F EY V ER IH T
FAVORITE(2)	F EY V R AH T
FAVORITES	F EY V ER IH T S
FAVORITES(2)	F EY V R AH T S
FAVOURITE	F EY V ER IH T
FAVOURITES	F AE V AH R AY T S
FEAR	F IH R
FEARED	F IH R D
FEARING	F IH R IH NG
FEARSOME	F IH R S AH M
FEAT	F IY T
FEATURE	F IY CH ER
FEATURED	F IY CH ER D
FEATURES	F IY CH ER Z
FEDERATION	F EH D ER EY SH AH N
FEEL	F IY L
FEELING	F IY L IH NG
FEELINGS	F IY L IH NG Z
FEELS	F IY L Z
FELL	F EH L
FELLOW	F EH L OW
FELT	F EH L T
FEMALE	F IY M EY L
FEMME	F EH M
FENCE	F EH N S
FEND	F EH N D
FEST	F EH S T
FESTIVAL	F EH S T AH V AH L
FESTIVAL(2)	F EH S T IH V AH L
FETCHING	F EH CH IH NG
FEUDING	F Y UW D IH NG
FEW	F Y UW
FI	F AY
FI(2)	F IY
FICTIONAL	F IH K SH AH N AH L
FIFTIES	F IH F T IY Z
FIGHT	F AY T
FIGHTING	F AY T IH NG
FIGHTS	F AY T S
FIGURE	F IH G Y ER
FILL	F IH L
FILLED	F IH L D
FILM	F IH L M
FILMED	F IH L M D
FILMING	F IH L M IH NG
FILMMAKERS	F IH L M EY K ER Z
FILMS	F IH L M Z
FILMSCHOOL	F IH L M S K UW L
FILTER	F IH L T ER
FINAL	F AY N AH L
FINALE	F AH N AE L IY
FINALIZING	F AY N AH L AY Z IH NG
FINALLY	F AY N AH L IY
FIND	F AY N D
FINDING	F AY N D IH NG
FINDS	F AY N D Z
FINE	F AY N
FINEST	F AY N AH S T
FINISH	F IH N IH SH
FINISHED	F IH N IH SH T
FIRE	F AY ER
FIRE(2)	F AY R
FIRES	F AY ER Z
FIRES(2)	F AY R Z
FIRESIDE	F AY ER S AY D
FIRESTORM	F AY R S T AO R M
FIRM	F ER M
FIRST	F ER S T
FIT	F IH T
FITS	F IH T S
FIVE	F AY V
FIX	F IH K S
FIXATION	F IH K S EY SH AH N
FLAMBOYANT	F L AE M B OY AH N T
FLAMES	F L EY M Z
FLASHED	F L AE SH T
FLASHY	F L AE SH IY
FLAT	F L AE T
FLAV	F L AE V
FLAVA	F L AE V AH
FLAWS	F L AO Z
FLEET	F L IY T
FLEETING	F L IY T IH NG
FLICK	F L IH K
FLLOW	F L OW
FLOODING	F L AH D IH NG
FLOPS	F L AA P S
FLOW	F L OW
FLOWERS	F L AW ER Z
FLU	F L UW
FLUFFY	F L AH F IY
FLUTE	F L UW T
FLYING	F L AY IH NG
FLYNN	F L IH N
FOCH	F AA CH
FOCUS	F OW K AH S
FOCUS(2)	F OW K IH S
FOCUSES	F OW K AH S IH Z
FOCUSES(2)	F OW K IH S IH Z
FOCUSING	F OW K AH S IH NG
FOCUSING(2)	F OW K IH S IH NG
FODDER	F AA D ER
FOIBLES	F OY B AH L Z
FOLKLORE	F OW K L AO R
FOLKS	F OW K S
FOLLOW	F AA L OW
FOLLOWED	F AA L OW D
FOLLOWING	F AA L OW IH NG
FOLLOWS	F AA L OW Z
FONTAINE	F AO N T EY N
FOOD	F UW D
FOODS	F UW D Z
FOOT	F UH T
FOOTAGE	F UH T IH JH
FOOTBALL	F UH T B AO L
FOR	F AO R
FOR(2)	F ER
FOR(3)	F R ER
FORCE	F AO R S
FORCED	F AO R S T
FORCES	F AO R S IH Z
FORESTALL	F AO R S T AO L
FOREVER	F ER EH V ER
FORGET	F ER G EH T
FORGET(2)	F AO R G EH T
FORGIVE	F ER G IH V
FORGIVE(2)	F AO R G IH V
FORGIVEN	F ER G IH V AH N
FORGIVEN(2)	F AO R G IH V AH N
FORGOT	F ER G AA T
FORGOT(2)	F AO R G AA T
FORMATIVE	F AO R M AH T IH V
FORMER	F AO R M ER
FORMS	F AO R M Z
FORMULA	F AO R M Y AH L AH
FORMULAIC	F AO R M Y AH L EY IH K
FORTH	F AO R TH
FORTUNATELY	F AO R CH AH N AH T L IY
FORTUNATELY(2)	F AO R CH UW N AH T L IY
FORTUNE	F AO R CH AH N
FORTUNE(2)	F AO R CH UW N
FORTUNES	F AO R CH AH N Z
FORTUNES(2)	F AO R CH UW N Z
FORWARD	F AO R W ER D
FOUND	F AW N D
FOUR	F AO R
FOURTH	F AO R TH
FOX	F AA K S
FOXY	F AA K S IY
FRAGMENT	F R AE G M AH N T
FRANCE	F R AE N S
FRANCES	F R AE N S IH S
FRANCISCO	F R AE N S IH S K OW
FRANK	F R AE NG K
FRANKLIN	F R AE NG K L IH N
FRANKLY	F R AE NG K L IY
FREAK	F R IY K
FREAKED	F R IY K T
FREAKS	F R IY K S
FRED	F R EH D
FREED	F R IY D
FREEDOM	F R IY D AH M
FRENCH	F R EH N CH
FRENZY	F R EH N Z IY
FREQUENTLY	F R IY K W AH N T L IY
FREQUENTLY(2)	F R IY K W EH N T L IY
FREQUENTS	F R IY K W AH N T S
FREQUENTS(2)	F R IY K W EH N T S
FRESH	F R EH SH
FRESHMAN	F R EH SH M AH N
FRIED	F R AY D
FRIED(2)	F R IY D
FRIEND	F R EH N D
FRIENDLY	F R EH N D L IY
FRIENDS	F R EH N D Z
FROG	F R AA G
FROLIC	F R AA L IH K
FROM	F R AH M
FRONT	F R AH N T
FROZEN	F R OW Z AH N
FRUSTRATING	F R AH S T R EY T IH NG
FULCI	F UH L S IY
FULFILLED	F UH L F IH L D
FULL	F UH L
FULLY	F UH L IY
FUN	F AH N
FUNDRAISER	F AH N D R EY Z ER
FUNNIER	F AH N IY ER
FUNNIEST	F AH N IY AH S T
FUNNY	F AH N IY
FURLONG	F ER L AO NG
FURNISHINGS	F ER N IH SH IH NG Z
FUSS	F AH S
FUTURE	F Y UW CH ER
FUZZY	F AH Z IY
G	JH IY
GACKT	G AE K T
GAGS	G AE G Z
GAINED	G EY N D
GALE	G EY L
GALORE	G AH L AO R
GAME	G EY M
GAMEPLAY	G EY M P L EY
GAMES	G EY M Z
GAMIN	G AE M AH N
GANG	G AE NG
GANGS	G AE NG Z
GANGSTER	G AE NG S T ER
GARSH	G AA R SH
GATHER	G AE DH ER
GAVE	G EY V
GAY	G EY
GEEK	G IY K
GEM	JH EH M
GENE	JH IY N
GENERAL	JH EH N ER AH L
GENERAL(2)	JH EH N R AH L
GENERALLY	JH EH N ER AH L IY
GENERALLY(2)	JH EH N R AH L IY
GENERATE	JH EH N ER EY T
GENERIC	JH AH N EH R IH K
GENEROUSLY	JH EH N ER AH S L IY
GENETICS	JH AH N EH T IH K S
GENIUS	JH IY N Y AH S
GENRE	ZH AA N R AH
GENTEEL	JH EH N T IY L
GENUINELY	JH EH N Y UW AH N L IY
GENUINELY(2)	JH EH N Y UW AY N L IY
GENUINENESS	JH EH N Y UW AH N IH S
GEORGE	JH AO R JH
GEORGIA	JH AO R JH AH
GEORGIAN	JH AO R JH AH N
GEORGY	JH AO R JH IY
GERALD	JH EH R AH L D
GERALDINE	JH EH R AH L D IY N
GERIATRIC	JH EH R IY AE T R IH K
GERMAN	JH ER M AH N
GERMANY	JH ER M AH N IY
GERMOGEL	JH AH R M AH JH AH L
GERSHWIN	G ER SH W IH N
GERSHWINS	JH AH R SH W AH N Z
GESTAPO	G AH S T AA P OW
GET	G EH T
GET(2)	G IH T
GETS	G EH T S
GETS(2)	G IH T S
GETTING	G EH T IH NG
GETTING(2)	G IH T IH NG
GHARANAS	G AE R AH N AH Z
GHOST	G OW S T
GHULAM	G Y UW L AE M
GIANCARLO	JH IY AE NG K AA R L OW
GIANNINI	JH AH N IY N IY
GIFTED	G IH F T AH D
GIFTED(2)	G IH F T IH D
GIFTS	G IH F T S
GIFTS(2)	G IH F S
GIG	G IH G
GIGGLES	G IH G AH L Z
GIMMICKS	G IH M IH K S
GINA	JH IY N AH
GIRL	G ER L
GIRLFRIEND	G ER L F R EH N D
GIRLHOOD	G ER L HH UH D
GIRLS	G ER L Z
GIVE	G IH V
GIVEN	G IH V AH N
GIVEN(2)	G IH V IH N
GIVER	G IH V ER
GIVES	G IH V Z
GIVING	G IH V IH NG
GLANCE	G L AE N S
GLENN	G L EH N
GLOBAL	G L OW B AH L
GLORY	G L AO R IY
GO	G OW
GOD	G AA D
GODDESS	G AA D AH S
GODFATHER	G AA D F AA DH ER
GOES	G OW Z
GOING	G OW IH NG
GOING(2)	G OW IH N
GOLD	G OW L D
GOLDEN	G OW L D AH N
GONE	G AO N
GOOD	G UH D
GOOD(2)	G IH D
GOODHEARTED	G UH D HH AA R T IH D
GOODNESS	G UH D N AH S
GOODNESS(2)	G UH D N IH S
GOODNIGHT	G UH D N AY T
GOODS	G UH D Z
GOOFS	G UW F S
GORDON	G AO R D AH N
GORE	G AO R
GORGEOUS	G AO R JH AH S
GOT	G AA T
GOTTA	G AA T AH
GOVERNMENT	G AH V ER N M AH N T
GOWN	G AW N
GPM	JH IY P IY M
GRACE	G R EY S
GRADE	G R EY D
GRADER	G R EY D ER
GRADUATION	G R AE JH UW EY SH AH N
GRADUATION(2)	G R AE JH AH W EY SH AH N
GRAND	G R AE N D
GRANDPARENT	G R AE N D P EH R AH N T
GRANTED	G R AE N T AH D
GRANTED(2)	G R AE N T IH D
GRANTED(3)	G R AE N AH D
GRANTED(4)	G R AE N IH D
GRAPHICS	G R AE F IH K S
GRASP	G R AE S P
GRASS	G R AE S
GRATUITOUS	G R AH T UW AH T AH S
GRATUITUS	G R AH T UW T AH S
GRAVE	G R EY V
GRAVEYARD	G R EY V Y AA R D
GRAVITAS	G R AE V AH T AH S
GREAT	G R EY T
GREATEST	G R EY T AH S T
GREATS	G R EY T S
GREECE	G R IY S
GREEK	G R IY K
GREEN	G R IY N
GREETING	G R IY T IH NG
GREW	G R UW
GREYTACK	G R EY T AE K
GRIM	G R IH M
GRIPPING	G R IH P IH NG
GRISBY	G R IH S B IY
GRIT	G R IH T
GROOVE	G R UW V
GROUNDHOG	G R AW N D HH AA G
GROUP	G R UW P
GROUPS	G R UW P S
GROWING	G R OW IH NG
GUARANTEE	G EH R AH N T IY
GUARD	G AA R D
GUARONTEE	G Y UW AH R AH N T IY IY
GUESS	G EH S
GUEST	G EH S T
GUIDE	G AY D
GUILTY	G IH L T IY
GUITAR	G IH T AA R
GUN	G AH N
GUNDAM	G AH N D AE M
GUS	G AH S
GUSTO	G AH S T OW
GUY	G AY
GUYS	G AY Z
GUÃ©TARY	G AH T EH R IY
GWYNETH	G W IH N AH TH
H	EY CH
HAD	HH AE D
HADN	HH AE D N
HAINES	HH EY N Z
HALF	HH AE F
HALL	HH AO L
HALLIDAY	HH AE L IH D EY
HALLUCINATIONS	HH AH L UW S AH N EY SH AH N Z
HAMLET	HH AE M L AH T
HAMLET(2)	HH AE M L IH T
HAMMY	HH AE M IY
HAMPER	HH AE M P ER
HAMPTON	HH AE M P T AH N
HAND	HH AE N D
HANDFUL	HH AE N D F UH L
HANDLE	HH AE N D AH L
HANDLED	HH AE N D AH L D
HANDS	HH AE N D Z
HANDS(2)	HH AE N Z
HANDSOME	HH AE N S AH M
HANGS	HH AE NG Z
HANNAH	HH AE N AH
HAPPEN	HH AE P AH N
HAPPENED	HH AE P AH N D
HAPPENING	HH AE P AH N IH NG
HAPPENING(2)	HH AE P N IH NG
HAPPENS	HH AE P AH N Z
HAPPILY	HH AE P AH L IY
HAPPY	HH AE P IY
HARA	HH EH R AH
HARALAMBOPOULOS	HH AH R AH L AE M B AH P AW L AH Z
HARD	HH AA R D
HARKER	HH AA R K ER
HAROLD	HH EH R AH L D
HARRIET	HH EH R IY AH T
HARRY	HH EH R IY
HARSH	HH AA R SH
HARTLEY	HH AA R T L IY
HARVARD	HH AA R V ER D
HAS	HH AE Z
HAS(2)	HH AH Z
HASN	HH AE Z N
HAT	HH AE T
HATED	HH EY T AH D
HATED(2)	HH EY T IH D
HAUNTING	HH AO N T IH NG
HAVE	HH AE V
HAVEN	HH EY V AH N
HAVING	HH AE V IH NG
HAWAII	HH AH W AY IY
HAWKING	HH AO K IH NG
HAYWORTH	HH EY W ER TH
HAZARDOUS	HH AE Z ER D AH S
HAZE	HH EY Z
HBO	EY CH B IY OW
HE	HH IY
HEADBANGERS	HH EH D B AE NG ER Z
HEADLINE	HH EH D L AY N
HEALTH	HH EH L TH
HEAR	HH IY R
HEARD	HH ER D
HEARFELT	HH IH ER F EH L T
HEARING	HH IY R IH NG
HEART	HH AA R T
HEARTED	HH AA R T AH D
HEARTED(2)	HH AA R T IH D
HEAVEN	HH EH V AH N
HEAVY	HH EH V IY
HECK	HH EH K
HEEL	HH IY L
HELEN	HH EH L AH N
HELL	HH EH L
HELLO	HH AH L OW
HELLO(2)	HH EH L OW
HELP	HH EH L P
HELPFUL	HH EH L P F AH L
HELPING	HH EH L P IH NG
HELPS	HH EH L P S
HELTE	HH EH L T
HENRI	HH EH N R IY
HENRI(2)	AO R IY
HENRI(3)	AA N R IY
HER	HH ER
HERE	HH IY R
HERO	HH IH R OW
HERO(2)	HH IY R OW
HEROINE	HH EH R OW AH N
HERSELF	HH ER S EH L F
HETEROSEXUALS	HH EH T ER OW S EH K SH UW AH L Z
HIDDEN	HH IH D AH N
HIDING	HH AY D IH NG
HIGH	HH AY
HIGHEST	HH AY AH S T
HIGHLIGHT	HH AY L AY T
HIGHLIGHTING	HH AY L AY T IH NG
HIGHLY	HH AY L IY
HIGHTOWER	HH AY T AW ER
HILARIOUS	HH IH L EH R IY AH S
HILL	HH IH L
HILLIARD	HH IH L Y AA R D
HILTON	HH IH L T AH N
HIM	HH IH M
HIM(2)	IH M
HIMSELF	HH IH M S EH L F
HINDS	HH AY N D Z
HINDSIGHT	HH AY N D S AY T
HINDSIGHT(2)	HH AY N S AY T
HIPNESS	HH IH P N AH S
HIRED	HH AY ER D
HIS	HH IH Z
HISTORIANS	HH IH S T AO R IY AH N Z
HISTORIC	HH IH S T AO R IH K
HISTORICAL	HH IH S T AO R IH K AH L
HISTORY	HH IH S T ER IY
HISTORY(2)	HH IH S T R IY
HIT	HH IH T
HITCH	HH IH CH
HITCHCOCK	HH IH CH K AA K
HITS	HH IH T S
HODGE	HH AA JH
HOFFMAN	HH AO F M AH N
HOKEY	HH OW K IY
HOLD	HH OW L D
HOLLYWOOD	HH AA L IY W UH D
HOLMES	HH OW M Z
HOLMES(2)	HH OW L M Z
HOM	HH AA M
HOMAGE	AA M AH JH
HOMAGE(2)	HH AA M AH JH
HOME	HH OW M
HOMEMADE	HH OW M M EY D
HOMEMADE(2)	HH OW M EY D
HOMETOWN	HH OW M T AW N
HOMOSEXUALS	HH OW M OW S EH K SH UW AH L Z
HONEST	AA N AH S T
HONESTLY	AA N AH S T L IY
HONESTLY(2)	AA N AH S L IY
HONESTY	AA N AH S T IY
HONG	HH AO NG
HONOR	AA N ER
HONORARY	AA N ER EH R IY
HONOURABLE	AA N ER AH B AH L
HOOFER	HH UW F ER
HOORAY	HH UH R EY
HOP	HH AA P
HOPE	HH OW P
HOPES	HH OW P S
HOPPER	HH AA P ER
HORRENDOUS	HH AO R EH N D AH S
HORRIBLE	HH AO R AH B AH L
HORRIFIC	HH AO R IH F IH K
HORROR	HH AO R ER
HORSE	HH AO R S
HOSTESS	HH OW S T AH S
HOSTILE	HH AA S T AH L
HOSTILE(2)	HH AA S T AY L
HOSTILITY	HH AA S T IH L AH T IY
HOUR	AW ER
HOUR(2)	AW R
HOURS	AW ER Z
HOURS(2)	AW R Z
HOUSE	HH AW S
HOW	HH AW
HOWARD	HH AW ER D
HOWEVER	HH AW EH V ER
HUGE	HH Y UW JH
HUGE(2)	Y UW JH
HUGELY	HH Y UW JH L IY
HUMAN	HH Y UW M AH N
HUMAN(2)	Y UW M AH N
HUMANITY	HH Y UW M AE N IH T IY
HUMANITY(2)	Y UW M AE N IH T IY
HUMANS	HH Y UW M AH N Z
HUMANS(2)	Y UW M AH N Z
HUMOR	HH Y UW M ER
HUMOROUS	HH Y UW M ER AH S
HUMOUR	HH Y UW M ER
HUNG	HH AH NG
HUNKY	HH AH NG K IY
HUNT	HH AH N T
HUNTER	HH AH N T ER
HURLED	HH ER L D
HURRICANE	HH ER AH K EY N
HURRICANE(2)	HH AH R AH K EY N Z
HURT	HH ER T
HURTING	HH ER T IH NG
HUSBAND	HH AH Z B AH N D
HYDE	HH AY D
HYPOCHONDRIAC	HH AY P AH K AA N D R IY AE K
I	AY
IAMASEAL	AY AH M EY Z IY AH L
IAN	IY AH N
ICE	AY S
ICONIC	AY K AA N IH K
IDA	AY D AH
IDEA	AY D IY AH
IDEAL	AY D IY L
IDEAS	AY D IY AH Z
IDENTITY	AY D EH N T AH T IY
IE	AY
IF	IH F
IGNORE	IH G N AO R
III	IY IY
ILL	IH L
IMAGE	IH M AH JH
IMAGE(2)	IH M IH JH
IMAGERY	IH M AH JH R IY
IMAGERY(2)	IH M IH JH R IY
IMAGES	IH M AH JH AH Z
IMAGES(2)	IH M IH JH IH Z
IMAGINATION	IH M AE JH AH N EY SH AH N
IMAGINATIVE	IH M AE JH AH N AH T IH V
IMAGINE	IH M AE JH AH N
IMAX	AY M AE K S
IMBUED	IH M B Y UW D
IMDB	IH M D
IMDBERS	IH M D EH R Z
IMHO	IH M HH OW
IMITATE	IH M AH T EY T
IMMATURE	IH M AH T Y UH R
IMMENSELY	IH M EH N S L IY
IMMERSES	IH M ER S IH Z
IMMERSING	IH M ER S IH NG
IMPACT	IH M P AE K T
IMPASSIONED	IH M P AE SH AH N D
IMPECCABLE	IH M P EH K AH B AH L
IMPERFECTIONS	IH M P ER F EH K SH AH N Z
IMPLAUSIBLE	IH M P L AO Z AH B AH L
IMPORTANT	IH M P AO R T AH N T
IMPOSSIBLE	IH M P AA S AH B AH L
IMPOTENT	IH M P AH T AH N T
IMPRESSED	IH M P R EH S T
IMPRESSION	IH M P R EH SH AH N
IMPRESSIONIST	IH M P R EH SH AH N AH S T
IMPRESSIONIST(2)	IH M P R EH SH AH N IH S T
IMPRESSIVE	IH M P R EH S IH V
IN	IH N
INABILITY	IH N AH B IH L IH T IY
INCLUDE	IH N K L UW D
INCLUDED	IH N K L UW D AH D
INCLUDED(2)	IH N K L UW D IH D
INCLUDING	IH N K L UW D IH NG
INCOMPARABLE	IH N K AA M P ER AH B AH L
INCOMPREHENSIBLE	IH NG K AA M P R AH HH EH N S IH B AH L
INCONGRUITY	IH NG K AO NG R UW IH T IY
INCREASED	IH N K R IY S T
INCREASINGLY	IH N K R IY S IH NG G L IY
INCREDIBLE	IH N K R EH D AH B AH L
INCREDIBLY	IH N K R EH D AH B L IY
INDEED	IH N D IY D
INDEPENDENT	IH N D IH P EH N D AH N T
INDIAN	IH N D IY AH N
INDIVIDUAL	IH N D AH V IH JH AH W AH L
INDUCED	IH N D UW S T
INDULGENT	IH N D AH L JH AH N T
INDUSTRIALIST	IH N D AH S T R IY AH L IH S T
INDUSTRY	IH N D AH S T R IY
INEXPENSIVE	IH N IH K S P EH N S IH V
INEXPERIENCED	IH N EH K S P IH R IY AH N S T
INEXPLICABLE	IH N AH K S P L IH K AH B AH L
INFAMOUS	IH N F AH M AH S
INFANT	IH N F AH N T
INFER	IH N F ER
INFERIOR	IH N F IH R IY ER
INFESTED	IH N F EH S T IH D
INFIDELITY	IH N F IH D EH L IH T IY
INFLUENCED	IH N F L UW AH N S T
INFLUENTIAL	IH N F L UW EH N SH AH L
INFO	IH N F OW
INFORMATION	IH N F AO R M EY SH AH N
INFORMED	IH N F AO R M D
INGENIOUS	IH N JH IY N Y AH S
INHABITANTS	IH N HH AE B IH T AH N T S
INHERIT	IH N HH EH R AH T
INHERITED	IH N HH EH R AH T IH D
INITIAL	IH N IH SH AH L
INITIALLY	IH N IH SH AH L IY
INNOCENT	IH N AH S AH N T
INQUISITIVE	IH N K W IH Z IH T IH V
INSATIABLE	IH N S EY SH AH B AH L
INSIDE	IH N S AY D
INSIDER	IH N S AY D ER
INSIGHTFUL	IH N S AY T F AH L
INSISTS	IH N S IH S T S
INSPIRED	IH N S P AY ER D
INSTALLMENT	IH N S T AO L M AH N T
INSTALMENTS	IH N S T AO L M AH N T S
INSTANCE	IH N S T AH N S
INSTANTS	IH N S T AH N T S
INSTEAD	IH N S T EH D
INSULT	IH N S AH L T
INSURANCE	IH N SH UH R AH N S
INSURED	IH N SH UH R D
INTELLIGENCE	IH N T EH L AH JH AH N S
INTELLIGENT	IH N T EH L AH JH AH N T
INTENDED	IH N T EH N D IH D
INTENDS	IH N T EH N D Z
INTENSIFIES	IH N T EH N S IH F AY Z
INTENSITY	IH N T EH N S IH T IY
INTENTIONALLY	IH N T EH N SH AH N AH L IY
INTERACT	IH N T ER AE K T
INTERACT(2)	IH N ER AE K T
INTERACTIONS	IH N T ER AE K SH AH N Z
INTERACTIONS(2)	IH N ER AE K SH AH N Z
INTERCUTTING	IH N T ER K AH T IH NG
INTEREST	IH N T AH R EH S T
INTERESTED	IH N T AH R EH S T IH D
INTERESTING	IH N T AH R EH S T IH NG
INTERNATIONAL	IH N T ER N AE SH AH N AA L
INTERNATIONAL(2)	IH N ER N AE SH AH N AA L
INTERNET	IH N T ER N EH T
INTERPRETATION	IH N T ER P R IH T EY SH AH N
INTERRUPTED	IH N T ER AH P T IH D
INTERTWINE	IH N T ER T W AY N
INTERVENES	IH N T ER V IY N Z
INTERVIEWS	IH N T ER V Y UW Z
INTO	IH N T UW
INTO(2)	IH N T AH
INTRICATELY	IH N T R AH K AH T L IY
INTRIGUING	IH N T R IY G IH NG
INTRODUCE	IH N T R AH D UW S
INTRODUCE(2)	IH N T R OW D UW S
INVETERATE	IH N V EH T ER AH T
INVOLVE	IH N V AA L V
INVOLVED	IH N V AA L V D
INVOLVEMENTS	IH N V AA L V M AH N T S
INVOLVES	IH N V AA L V Z
IPOLITE	IH P AH L AY T
IRA	AY R AH
IRA(2)	AY AA R EY
IRAN	IH R AA N
IRAN(2)	AY R AE N
IRANIAN	IH R AA N IY AH N
IRANIAN(2)	AY R EY N IY AH N
IRENE	AY R IY N
IRISH	AY R IH SH
IRONICALLY	AY R AA N IH K L IY
IRONY	AY R AH N IY
IRRITATING	IH R AH T EY T IH NG
IRVING	ER V IH NG
IS	IH Z
ISLAND	AY L AH N D
ISN	IH Z N
ISSUE	IH SH UW
ISSUES	IH SH UW Z
IT	IH T
ITALIAN	IH T AE L Y AH N
ITS	IH T S
ITSELF	IH T S EH L F
IZUMO	AH Z UW M OW
IZURUHA	AH Z UH R AH HH AH
J	JH EY
JACK	JH AE K
JACKSON	JH AE K S AH N
JAFAR	JH EY F AH R
JAIL	JH EY L
JAKU	JH AE K UW
JAMES	JH EY M Z
JAMIE	JH EY M IY
JANE	JH EY N
JAPAN	JH AH P AE N
JAPANESE	JH AE P AH N IY Z
JARRING	JH AA R IH NG
JEALOUS	JH EH L AH S
JEANNOT	JH IY N AH T
JEFF	JH EH F
JEREMY	JH EH R AH M IY
JERSEY	JH ER Z IY
JIM	JH IH M
JIMMY	JH IH M IY
JOAN	JH OW N
JOB	JH AA B
JOB(2)	JH OW B
JOBS	JH AA B Z
JOCK	JH AA K
JOE	JH OW
JOEY	JH OW IY
JOHN	JH AA N
JOHNSON	JH AA N S AH N
JOKE	JH OW K
JOKES	JH OW K S
JON	JH AA N
JOSEF	JH OW S AH F
JOURNEY	JH ER N IY
JOY	JH OY
JOYFUL	JH OY F AH L
JOYRIDE	JH OY R AY D
JUGGLES	JH AH G AH L Z
JULIET	JH UW L IY EH T
JUNIOR	JH UW N Y ER
JUST	JH AH S T
JUST(2)	JH IH S T
JUSTIFYING	JH AH S T AH F AY IH NG
K	K EY
KABUKI	K AH B UW K IY
KAMAL	K EY M AH L
KANE	K EY N
KATE	K EY T
KATHAK	K AE TH AH K
KAVOGIANNI	K AH V OW JH IY AE N IY
KAY	K EY
KEEP	K IY P
KEEPING	K IY P IH NG
KEEPS	K IY P S
KELLY	K EH L IY
KEN	K EH N
KENNETH	K EH N IH TH
KENNY	K EH N IY
KENTUCKY	K AH N T AH K IY
KEPT	K EH P T
KEPT(2)	K AE P T
KESEY	K S IY
KETTY	K EH T IY
KICK	K IH K
KICKOFF	K IH K AO F
KID	K IH D
KIDNAPPED	K IH D N AE P T
KIDNAPPING	K IH D N AE P IH NG
KIDS	K IH D Z
KILL	K IH L
KILLED	K IH L D
KILLER	K IH L ER
KILLERS	K IH L ER Z
KILLING	K IH L IH NG
KILLS	K IH L Z
KILMER	K IH L M ER
KIND	K AY N D
KINDA	K IH N D AH
KINDS	K AY N D Z
KINDS(2)	K AY N Z
KING	K IH NG
KIRK	K ER K
KITCHEN	K IH CH AH N
KNEW	N UW
KNEW(2)	N Y UW
KNIFE	N AY F
KNIGHTLEY	N AY T L IY
KNOCKS	N AA K S
KNOW	N OW
KNOWING	N OW IH NG
KNOWLEDGE	N AA L AH JH
KNOWLEDGE(2)	N AA L IH JH
KNOWN	N OW N
KNOWS	N OW Z
KONG	K AO NG
KONG(2)	K AO NG G
KONSTADINOU	K AA N S T AE D AH N UW
KORDA	K AO R D AH
KOTE	K OW T
KUDOS	K UW D OW S
KUMAR	K UW M AA R
KUMARI	K Y UW M AH R IY
KURT	K ER T
LA	L AA
LACED	L EY S T
LACK	L AE K
LACKING	L AE K IH NG
LACKLUSTRE	L AE K L AH S T ER
LACKS	L AE K S
LADIES	L EY D IY Z
LADY	L EY D IY
LAMBERTO	L AA M B EH R T OW
LAME	L EY M
LAMPOONING	L AE M P UW N IH NG
LANDIS	L AE N D IH S
LANDS	L AE N D Z
LANDÂ…	L AE N D
LANGUAGE	L AE NG G W AH JH
LANGUAGE(2)	L AE NG G W IH JH
LANGUAGES	L AE NG G W AH JH AH Z
LANGUAGES(2)	L AE NG G W IH JH IH Z
LANSBURY	L AE N Z B ER IY
LARA	L AA R AH
LARGE	L AA R JH
LARGER	L AA R JH ER
LAST	L AE S T
LASTED	L AE S T AH D
LASTED(2)	L AE S T IH D
LATE	L EY T
LATELY	L EY T L IY
LATER	L EY T ER
LATEST	L EY T AH S T
LATTER	L AE T ER
LAUGH	L AE F
LAUGHED	L AE F T
LAUGHING	L AE F IH NG
LAUGHS	L AE F S
LAUGHTER	L AE F T ER
LAUNCHING	L AO N CH IH NG
LAW	L AO
LAW(2)	L AA
LAWS	L AO Z
LAWYERS	L AO Y ER Z
LAWYERS(2)	L OY ER Z
LAZERS	L EY Z ER Z
LEAD	L EH D
LEAD(2)	L IY D
LEADER	L IY D ER
LEADING	L IY D IH NG
LEAP	L IY P
LEARN	L ER N
LEARNING	L ER N IH NG
LEARNS	L ER N Z
LEARY	L IH R IY
LEAST	L IY S T
LEAVE	L IY V
LEAVES	L IY V Z
LEAVING	L IY V IH NG
LED	L EH D
LEE	L IY
LEFT	L EH F T
LEFTOVER	L EH F T OW V ER
LEGAL	L IY G AH L
LEGEND	L EH JH AH N D
LEGS	L EH G Z
LEISURELY	L IY Z ER L IY
LENGTH	L EH NG K TH
LENGTH(2)	L EH NG TH
LENGTHY	L EH NG TH IY
LEONARDO	L IY AH N AA R D OW
LEONOV	L IY AH N AH V
LESBIAN	L EH Z B IY AH N
LESLIE	L EH S L IY
LESS	L EH S
LESSER	L EH S ER
LESSON	L EH S AH N
LESSONS	L EH S AH N Z
LEST	L EH S T
LET	L EH T
LETTER	L EH T ER
LETTING	L EH T IH NG
LEVANT	L AH V AE N T
LEVEL	L EH V AH L
LEVELS	L EH V AH L Z
LEVIN	L EH V IH N
LEVIN(2)	L AH V IH N
LEWIS	L UW IH S
LIBERALLY	L IH B ER AH L IY
LIBRARIAN	L AY B R EH R IY AH N
LIBRARY	L AY B R EH R IY
LIE	L AY
LIED	L AY D
LIES	L AY Z
LIFE	L AY F
LIGHT	L AY T
LIKABLE	L AY K AH B AH L
LIKE	L AY K
LIKED	L AY K T
LIKELY	L AY K L IY
LILLIAN	L IH L IY AH N
LINDSAY	L IH N D Z IY
LINE	L AY N
LINES	L AY N Z
LIOTTA	L IY OW T AH
LIP	L IH P
LISA	L IY S AH
LISTENER	L IH S AH N ER
LISTENER(2)	L IH S N ER
LITERALLY	L IH T ER AH L IY
LITERALLY(2)	L IH T R AH L IY
LITTLE	L IH T AH L
LIVE	L AY V
LIVE(2)	L IH V
LIVED	L IH V D
LIVED(2)	L AY V D
LIVES	L IH V Z
LIVES(2)	L AY V Z
LIVING	L IH V IH NG
LL	EH L
LLOYD	L OY D
LOCAL	L OW K AH L
LOCATION	L OW K EY SH AH N
LOCATIONS	L OW K EY SH AH N Z
LODGER	L AA JH ER
LONG	L AO NG
LONGER	L AO NG G ER
LOOK	L UH K
LOOKED	L UH K T
LOOKING	L UH K IH NG
LOOKS	L UH K S
LOONY	L UW N IY
LORD	L AO R D
LOSE	L UW Z
LOSER	L UW Z ER
LOSES	L UW Z IH Z
LOSING	L UW Z IH NG
LOST	L AO S T
LOT	L AA T
LOT(2)	L AO T
LOTS	L AA T S
LOTTERY	L AA T ER IY
LOUD	L AW D
LOUIS	L UW IH S
LOUIS(2)	L UW IY
LOVABLENESS	L AH V AH B AH L N AH S
LOVE	L AH V
LOVED	L AH V D
LOVELIER	L AH V L IY ER
LOVELY	L AH V L IY
LOVER	L AH V ER
LOVERS	L AH V ER Z
LOVES	L AH V Z
LOVING	L AH V IH NG
LOW	L OW
LOWER	L OW ER
LOWLIFES	L OW L AY F S
LUCIO	L UW S IY OW
LUCKY	L AH K IY
LUDICROUS	L UW D AH K R AH S
LUFT	L AH F T
LUFTENS	L AH F T AH N Z
LUMET	L UW M AH T
LUNG	L AH NG
LUSH	L AH SH
LUSTING	L AH S T IH NG
LYLE	L AY L
LYNCH	L IH N CH
LYRICISM	L IH R IH S IH Z AH M
LYRICIST	L IH R IH S IH S T
M	EH M
MADE	M EY D
MAGIC	M AE JH IH K
MAGICAL	M AE JH IH K AH L
MAGNETIC	M AE G N EH T IH K
MAGNIFICENT	M AE G N IH F AH S AH N T
MAGNIFICENT(2)	M AE G N IH F IH S AH N T
MAIL	M EY L
MAIN	M EY N
MAINLY	M EY N L IY
MAJOR	M EY JH ER
MAJORITY	M AH JH AO R AH T IY
MAKE	M EY K
MAKES	M EY K S
MAKING	M EY K IH NG
MALE	M EY L
MALEFICENT	M AH L AH F IH S AH N T
MALEVOLENT	M AH L EH V AH L AH N T
MALLEPA	M AE L EH P AH
MAN	M AE N
MANAGE	M AE N AH JH
MANAGE(2)	M AE N IH JH
MANAGES	M AE N IH JH IH Z
MANGA	M AE NG G AH
MANHATTAN	M AE N HH AE T AH N
MANIAC	M EY N IY AE K
MANIPULATE	M AH N IH P Y AH L EY T
MANIPULATION	M AH N IH P Y AH L EY SH AH N
MANN	M AE N
MANNER	M AE N ER
MANY	M EH N IY
MANZANO	M AA N Z AA N OW
MARC	M AA R K
MARCO	M AA R K OW
MARIA	M ER IY AH
MARIETTE	M EH R IY EH T
MARINE	M ER IY N
MARITAL	M AE R AH T AH L
MARK	M AA R K
MARKET	M AA R K AH T
MARKET(2)	M AA R K IH T
MARLON	M AA R L AH N
MARRIAGE	M EH R IH JH
MARRIED	M EH R IY D
MARRIES	M EH R IY Z
MARTIAL	M AA R SH AH L
MARTIN	M AA R T AH N
MARTIN(2)	M AA R T IH N
MARY	M EH R IY
MARYLAND	M EH R AH L AH N D
MASKED	M AE S K T
MASS	M AE S
MASSACRE	M AE S AH K ER
MASSES	M AE S AH Z
MASSES(2)	M AE S IH Z
MASSEY	M AE S IY
MASSIVE	M AE S IH V
MASTER	M AE S T ER
MASTERFUL	M AE S T ER F AH L
MASTERLY	M AE S T ER L IY
MASTERPIECE	M AE S T ER P IY S
MASTERPIECES	M AE S T ER P IY S AH Z
MASTERPIECES(2)	M AE S T ER P IY S IH Z
MASTERS	M AE S T ER Z
MASTERSON	M AE S T ER S AH N
MATCH	M AE CH
MATCHED	M AE CH T
MATERIAL	M AH T IH R IY AH L
MATT	M AE T
MATTER	M AE T ER
MATTERED	M AE T ER D
MATURE	M AH CH UH R
MATURE(2)	M AH T Y UH R
MATURELY	M AH T Y UH R L IY
MAURICE	M AO R IY S
MAURICE(2)	M AA R IH S
MAX	M AE K S
MAY	M EY
MAYBE	M EY B IY
MAYER	M EY ER
MAYOR	M EY ER
MCBAIN	M AH K B EY N
MCCOY	M AH K OY
MCKENZIE	M AH K EH N Z IY
ME	M IY
MEAN	M IY N
MEANING	M IY N IH NG
MEANS	M IY N Z
MEANT	M EH N T
MEANWHILE	M IY N W AY L
MEAT	M IY T
MEDAL	M EH D AH L
MEDIA	M IY D IY AH
MEDIATION	M IY D IY EY SH AH N
MEEK	M IY K
MEENA	M IY N AH
MEET	M IY T
MEETING	M IY T IH NG
MEETS	M IY T S
MELANGE	M EH L AE NG
MELODIES	M EH L AH D IY Z
MELODRAMA	M EH L AH D R AA M AH
MELODRAMATIC	M EH L AH D R AH M AE T IH K
MEMBER	M EH M B ER
MEMBERS	M EH M B ER Z
MEMORABLE	M EH M ER AH B AH L
MEMORY	M EH M ER IY
MEN	M EH N
MENACING	M EH N AH S IH NG
MENTAL	M EH N T AH L
MENTALITY	M EH N T AE L AH T IY
MENTALITY(2)	M EH N T AE L IH T IY
MENTIONED	M EH N SH AH N D
MENTIONS	M EH N SH AH N Z
MERE	M IH R
MERELY	M IH R L IY
MERYL	M EH R AH L
MESH	M EH SH
MESS	M EH S
MESSAGE	M EH S AH JH
MESSAGE(2)	M EH S IH JH
MESSAGES	M EH S AH JH AH Z
MESSAGES(2)	M EH S IH JH IH Z
MET	M EH T
METAL	M EH T AH L
METHOD	M EH TH AH D
METICULOUS	M AH T IH K Y AH L AH S
MEXICO	M EH K S AH K OW
MGM	EH M G IY EH M
MICE	M AY S
MICHAEL	M AY K AH L
MICHELE	M IH SH EH L
MID	M IH D
MIDDLE	M IH D AH L
MIDDLING	M IH D AH L IH NG
MIDDLING(2)	M IH D L IH NG
MIGHT	M AY T
MILLE	M IH L
MILLER	M IH L ER
MILLION	M IH L Y AH N
MILO	M AY L OW
MIMICKING	M IH M IH K IH NG
MIND	M AY N D
MINDFU	M IH N D F UW
MINDS	M AY N D Z
MINE	M AY N
MINELLI	M IH N EH L IY
MINUTE	M IH N AH T
MINUTE(2)	M AY N UW T
MINUTE(3)	M AY N Y UW T
MINUTES	M IH N AH T S
MIRACLE	M IH R AH K AH L
MIRROR	M IH R ER
MISCONCEPTIONS	M IH S K AH N S EH P SH AH N Z
MISE	M IH S
MISERY	M IH Z ER IY
MISINFORMATION	M IH S IH N F ER M EY SH AH N
MISLEADING	M IH S L IY D IH NG
MISS	M IH S
MISSED	M IH S T
MISSES	M IH S IH Z
MISSING	M IH S IH NG
MISSION	M IH SH AH N
MISTAKE	M IH S T EY K
MISTAKEN	M IH S T EY K AH N
MITCHELL	M IH CH AH L
MIX	M IH K S
MIXED	M IH K S T
MOBILE	M OW B AH L
MOCKING	M AA K IH NG
MOCKUMENTARY	M AA K Y UW M AH N T EH R IY
MODEL	M AA D AH L
MODERATELY	M AA D ER AH T L IY
MODERN	M AA D ER N
MODUS	M OW D AH S
MOGULS	M OW G AH L Z
MOLLY	M AA L IY
MOMENT	M OW M AH N T
MOMENTS	M OW M AH N T S
MONEY	M AH N IY
MONGER	M AH NG G ER
MONO	M OW N OW
MONTAGE	M AA N T AA ZH
MONTANA	M AA N T AE N AH
MONTAUK	M AA N T AH K
MONTHS	M AH N TH S
MONTREAL	M AH N T R IY AO L
MONUMENTAL	M AA N Y AH M EH N T AH L
MONUMENTAL(2)	M AA N Y AH M EH N AH L
MONUMENTAL(3)	M AA N Y UW M EH N T AH L
MOOD	M UW D
MOON	M UW N
MOONCHILD	M UW N CH AY L D
MOONWALKER	M UW N W AO K ER
MOPE	M OW P
MORAL	M AO R AH L
MORALITY	M AO R AE L AH T IY
MORANT	M AO R AH N T
MORAYS	M ER EY Z
MORAYS(2)	M AO R EY Z
MORBID	M AO R B AH D
MORE	M AO R
MORES	M AO R EY Z
MORES(2)	M AO R IY Z
MORNING	M AO R N IH NG
MOSQUE	M AA S K
MOSQUE(2)	M AO S K
MOST	M OW S T
MOST(2)	M OW S
MOSTLY	M OW S T L IY
MOSTLY(2)	M OW S L IY
MOTHER	M AH DH ER
MOTIF	M OW T IY F
MOTIFS	M OW T IY F S
MOTION	M OW SH AH N
MOUSE	M AW S
MOVE	M UW V
MOVEMENT	M UW V M AH N T
MOVES	M UW V Z
MOVIE	M UW V IY
MOVIES	M UW V IY Z
MOVING	M UW V IH NG
MR	M IH S T ER
MS	M IH Z
MUCH	M AH CH
MUDDLED	M AH D AH L D
MULTI	M AH L T IY
MULTICULTURAL	M AH L T IY K AH L CH ER AH L
MUMBLES	M AH M B AH L Z
MURDER	M ER D ER
MURDERED	M ER D ER D
MURDEROUS	M ER D ER AH S
MURKY	M ER K IY
MUSIC	M Y UW Z IH K
MUSICAL	M Y UW Z IH K AH L
MUSICALS	M Y UW Z IH K AH L Z
MUSICIANS	M Y UW Z IH SH AH N Z
MUSINGS	M Y UW Z IH NG Z
MUST	M AH S T
MY	M AY
MYRA	M AY R AH
MYSELF	M AY S EH L F
MYSTERIOUS	M IH S T IH R IY AH S
MYSTERY	M IH S T ER IY
N	EH N
NAGS	N AE G Z
NAILED	N EY L D
NAIVE	N AY IY V
NAME	N EY M
NAMED	N EY M D
NAMES	N EY M Z
NANCY	N AE N S IY
NARRATE	N EH R EY T
NARRATIVE	N AE R AH T IH V
NARRATIVE(2)	N EH R AH T IH V
NATHAN	N EY TH AH N
NATION	N EY SH AH N
NATIVE	N EY T IH V
NATURAL	N AE CH ER AH L
NATURAL(2)	N AE CH R AH L
NATUREÂ…IT	N AE T Y AH R IY T
NAUSHADS	N AO SH AH D Z
NAVIGATE	N AE V AH G EY T
ND	EH N D
NEAR	N IH R
NEARLY	N IH R L IY
NECESSITY	N AH S EH S AH T IY
NECESSITY(2)	N AH S EH S IH T IY
NECKS	N EH K S
NED	N EH D
NEED	N IY D
NEEDED	N IY D AH D
NEEDED(2)	N IY D IH D
NEEDLESS	N IY D L AH S
NEEDS	N IY D Z
NEITHER	N IY DH ER
NEITHER(2)	N AY DH ER
NETWORK	N EH T W ER K
NEUROTIC	N UH R AA T IH K
NEUTRAL	N UW T R AH L
NEVER	N EH V ER
NEVERTHELESS	N EH V ER DH AH L EH S
NEW	N UW
NEW(2)	N Y UW
NEWBIE	N UW B IY
NEWNESS	N UW N AH S
NEWT	N UW T
NEWTYPES	N UW T AY P S
NEXT	N EH K S T
NEXT(2)	N EH K S
NICE	N AY S
NICE(2)	N IY S
NICK	N IH K
NICKNAME	N IH K N EY M
NICOLAS	N IH K AO L AH S
NIGH	N AY
NIGHT	N AY T
NIGHTMARE	N AY T M EH R
NIGHTMARES	N AY T M EH R Z
NIGHTMARISH	N AY T M EH R IH SH
NIGHTS	N AY T S
NIKAH	N IH K AH
NIKOLAIDIS	N IH K AH L EY D AH S
NINA	N IY N AH
NINE	N AY N
NO	N OW
NOBILITY	N OW B IH L AH T IY
NOBODY	N OW B AA D IY
NOBODY(2)	N OW B AH D IY
NOD	N AA D
NOIR	N OY R
NOMINATED	N AA M AH N EY T AH D
NONE	N AH N
NONETHELESS	N AH N DH AH L EH S
NONSENSICAL	N AA N S EH N S IH K AH L
NOR	N AO R
NORMAL	N AO R M AH L
NORMALLY	N AO R M AH L IY
NORMALLY(2)	N AO R M L IY
NORTH	N AO R TH
NORTHAM	N AO R TH AH M
NOSE	N OW Z
NOSTALGIA	N AO S T AE L JH AH
NOT	N AA T
NOTABLY	N OW T AH B L IY
NOTCH	N AA CH
NOTE	N OW T
NOTED	N OW T AH D
NOTED(2)	N OW T IH D
NOTES	N OW T S
NOTHING	N AH TH IH NG
NOTICE	N OW T AH S
NOTICE(2)	N OW T IH S
NOVEL	N AA V AH L
NOW	N AW
NUANCE	N UW AA N S
NUDE	N UW D
NUDITY	N UW D IH T IY
NUMBER	N AH M B ER
NUMBERS	N AH M B ER Z
NURSES	N ER S AH Z
NURSES(2)	N ER S IH Z
NWA	N W AA
NWH	EH N D AH B AH L Y UW
O	OW
OBJECTIVE	AH B JH EH K T IH V
OBLIGATORY	AH B L IH G AH T AO R IY
OBNOXIOUS	AA B N AA K SH AH S
OBSERVING	AH B Z ER V IH NG
OBSESSED	AH B S EH S T
OBSESSION	AH B S EH SH AH N
OBTAIN	AH B T EY N
OBTAINED	AH B T EY N D
OBTRUSIVE	AH B T R UW S IH V
OBVIOUS	AA B V IY AH S
OBVIOUSLY	AA B V IY AH S L IY
OCCASIONALLY	AO K EY ZH AH N AH L IY
OCCUPANTS	AA K Y AH P AH N T S
OCCUPIED	AA K Y AH P AY D
ODD	AA D
ODDYSEY	AA D AH Z IY
OF	AH V
OFF	AO F
OFFERED	AO F ER D
OFFERS	AO F ER Z
OFFICER	AO F AH S ER
OFFICER(2)	AO F IH S ER
OFFICERS	AO F AH S ER Z
OFFICERS(2)	AO F IH S ER Z
OFFSIDE	AO F S AY D
OFTEN	AO F T AH N
OFTEN(2)	AO F AH N
OGRE	OW G ER
OH	OW
OHIO	OW HH AY OW
OK	OW K EY
OLD	OW L D
OLDER	OW L D ER
OLDEST	OW L D AH S T
OLEN	AA L AH N
OLIVER	AA L AH V ER
OLIVER(2)	AA L IH V ER
ON	AA N
ON(2)	AO N
ONCE	W AH N S
ONE	W AH N
ONE(2)	HH W AH N
ONES	W AH N Z
ONLINE	AO N L AY N
ONLY	OW N L IY
ONMYOJI	AA N M AY AH JH IY
ONTO	AA N T UW
ONTO(2)	AO N T UW
OOD	UW D
OOPS	UW P S
OPEN	OW P AH N
OPENED	OW P AH N D
OPENING	OW P AH N IH NG
OPENLY	OW P AH N L IY
OPENS	OW P AH N Z
OPERANDI	AA P ER AE N D IY
OPERANDI(2)	AA P ER AE N D AY
OPERANDI(3)	AA P ER EH N D AY
OPINION	AH P IH N Y AH N
OPPOSED	AH P OW Z D
OPPOSES	AH P OW Z IH Z
OPPOSING	AH P OW Z IH NG
OPPOSITE	AA P AH Z IH T
OPPRESSIVE	AH P R EH S IH V
OPTIMISM	AA P T AH M IH Z AH M
OPULENT	AA P Y AH L AH N T
OR	AO R
OR(2)	ER
ORCHESTRAL	AO R K EH S T R AH L
ORCO	AO R K OW
ORDER	AO R D ER
OREGON	AO R AH G AH N
OREGON(2)	AO R AH G AA N
OREGONIAN	AO R AH G OW N IY AH N
ORGANIZED	AO R G AH N AY Z D
ORIENTED	AO R IY EH N T AH D
ORIENTED(2)	AO R IY EH N T IH D
ORIGIN	AO R AH JH AH N
ORIGINAL	ER IH JH AH N AH L
ORIGINALITY	ER IH JH AH N AE L IH T IY
ORIGINALLY	ER IH JH AH N AH L IY
ORIGINALLY(2)	ER IH JH N AH L IY
ORIGINS	AO R AH JH IH N Z
ORPHANS	AO R F AH N Z
ORSON	AO R S AH N
ORWELL	AO R W EH L
OSCAR	AO S K ER
OSCARS	AO S K ER Z
OTHER	AH DH ER
OTHERS	AH DH ER Z
OTHERWISE	AH DH ER W AY Z
OUR	AW ER
OUR(2)	AW R
OUR(3)	AA R
OURSELVES	AW ER S EH L V Z
OURSELVES(2)	AA R S EH L V Z
OUT	AW T
OUTCOME	AW T K AH M
OUTSIDE	AW T S AY D
OUTSIDER	AW T S AY D ER
OUTSIDERS	AW T S AY D ER Z
OUTSTANDING	AW T S T AE N D IH NG
OVER	OW V ER
OVERACTING	OW V ER AE K T IH NG
OVERALL	OW V ER AO L
OVERCOME	OW V ER K AH M
OVERDONE	OW V ER D AH N
OVERSHADOWED	OW V ER SH AE D OW D
OVERWEIGHT	OW V ER W EY T
OVERWHELMING	OW V ER W EH L M IH NG
OVERWHELMING(2)	OW V ER HH W EH L M IH NG
OWN	OW N
OWNER	OW N ER
OXFORD	AA K S F ER D
P	P IY
PACE	P EY S
PACED	P EY S T
PACING	P EY S IH NG
PACKAGE	P AE K AH JH
PACKAGE(2)	P AE K IH JH
PACKED	P AE K T
PAD	P AE D
PAGE	P EY JH
PAID	P EY D
PAIN	P EY N
PAINTED	P EY N T AH D
PAINTED(2)	P EY N T IH D
PAINTED(3)	P EY N AH D
PAINTED(4)	P EY N IH D
PAINTERS	P EY N T ER Z
PAINTERS(2)	P EY N ER Z
PAINTING	P EY N T IH NG
PAINTING(2)	P EY N IH NG
PAINTS	P EY N T S
PAJAMA	P AH JH AA M AH
PAJAMA(2)	P AH JH AE M AH
PAKEEZAH	P EY K IY Z AH
PAL	P AE L
PALE	P EY L
PALETTE	P AE L AH T
PALPABLE	P AE L P AH B AH L
PALSY	P AO L Z IY
PALTROW	P AE L T R OW
PANAHI	P AE N AH HH IY
PANNED	P AE N D
PAOLO	P AW L OW
PAPAL	P EY P AH L
PAR	P AA R
PARACHUTING	P EH R AH SH UW T IH NG
PARANOIA	P EH R AH N OY AH
PARAPHRASED	P AE R AH F R EY Z D
PARAPHRASING	P EH R AH F R EY Z IH NG
PARENT	P EH R AH N T
PARENTS	P EH R AH N T S
PARIS	P EH R IH S
PARIS(2)	P AE R IH S
PARKER	P AA R K ER
PARODY	P EH R AH D IY
PART	P AA R T
PARTIAL	P AA R SH AH L
PARTIALLY	P AA R SH AH L IY
PARTIALLY(2)	P AA R SH L IY
PARTICULAR	P ER T IH K Y AH L ER
PARTICULAR(2)	P AA T IH K Y AH L ER
PARTICULARLY	P AA R T IH K Y AH L ER L IY
PARTICULARLY(2)	P ER T IH K Y AH L ER L IY
PARTLY	P AA R T L IY
PARTNER	P AA R T N ER
PARTS	P AA R T S
PARTY	P AA R T IY
PASDAR	P AE Z D AH R
PASSAGE	P AE S AH JH
PASSAGE(2)	P AE S IH JH
PASSED	P AE S T
PASSES	P AE S AH Z
PASSES(2)	P AE S IH Z
PASSING	P AE S IH NG
PASSION	P AE SH AH N
PASSIONATE	P AE SH AH N AH T
PASSWORTHY	P AE S W ER DH IY
PAST	P AE S T
PATHAR	P AE TH ER
PATIENT	P EY SH AH N T
PATRICK	P AE T R IH K
PATRIOTS	P EY T R IY AH T S
PAY	P EY
PAYING	P EY IH NG
PAYS	P EY Z
PD	P IY D
PEACE	P IY S
PEANUTS	P IY N AH T S
PECULIAR	P AH K Y UW L Y ER
PECULIAR(2)	P IH K Y UW L Y ER
PEDIGREE	P EH D AH G R IY
PEEK	P IY K
PENCE	P EH N S
PENNED	P EH N D
PEOPLE	P IY P AH L
PEOPLES	P IY P AH L Z
PERCEIVE	P ER S IY V
PERCENT	P ER S EH N T
PERFECT	P ER F EH K T
PERFECT(2)	P ER F IH K T
PERFECTED	P ER F EH K T AH D
PERFECTLY	P ER F AH K T L IY
PERFECTLY(2)	P ER F AH K L IY
PERFORMANCE	P ER F AO R M AH N S
PERFORMANCES	P ER F AO R M AH N S AH Z
PERFORMANCES(2)	P ER F AO R M AH N S IH Z
PERHAPS	P ER HH AE P S
PERIOD	P IH R IY AH D
PERMANENT	P ER M AA N EH N T
PERSON	P ER S AH N
PERSONA	P ER S OW N AH
PERSONAL	P ER S IH N AH L
PERSONALITY	P ER S AH N AE L IH T IY
PERSONALLY	P ER S AH N AH L IY
PERSONS	P ER S AH N Z
PERSPECTIVE	P ER S P EH K T IH V
PET	P EH T
PETTIT	P EH T IH T
PHENOMENAL	F AH N AA M AH N AH L
PHILLIP	F IH L IH P
PHILOSOPHICAL	F IH L AH S AA F IH K AH L
PHOENIX	F IY N IH K S
PHONY	F OW N IY
PHOOL	F UW L
PHOTOGRAPHED	F OW T AH G R AE F T
PHOTOGRAPHY	F AH T AA G R AH F IY
PIANIST	P IY AE N AH S T
PIANIST(2)	P IY AA N AH S T
PIANIST(3)	P IY AH N IH S T
PICKFORD	P IH K F ER D
PICTURE	P IH K CH ER
PICTURES	P IH K CH ER Z
PIECE	P IY S
PIECES	P IY S AH Z
PIECES(2)	P IY S IH Z
PILOT	P AY L AH T
PIPE	P AY P
PIT	P IH T
PITA	P IY T AH
PITCH	P IH CH
PLACE	P L EY S
PLACED	P L EY S T
PLACES	P L EY S AH Z
PLACES(2)	P L EY S IH Z
PLAIN	P L EY N
PLAN	P L AE N
PLANE	P L EY N
PLANET	P L AE N AH T
PLANNING	P L AE N IH NG
PLANS	P L AE N Z
PLAY	P L EY
PLAYED	P L EY D
PLAYER	P L EY ER
PLAYERS	P L EY ER Z
PLAYING	P L EY IH NG
PLAYS	P L EY Z
PLAYWRIGHT	P L EY R AY T
PLEAD	P L IY D
PLEASANT	P L EH Z AH N T
PLEASANTLY	P L EH Z AH N T L IY
PLEASANTVILLE	P L EH Z AH N T V IH L
PLEASE	P L IY Z
PLEASING	P L IY Z IH NG
PLEASURE	P L EH ZH ER
PLENTY	P L EH N T IY
PLENTY(2)	P L EH N IY
PLODS	P L AA D Z
PLOT	P L AA T
PLOTS	P L AA T S
PLOTTED	P L AA T AH D
PLOTTED(2)	P L AA T IH D
PLUMP	P L AH M P
PLUS	P L AH S
POCKET	P AA K AH T
PODGE	P AA JH
POETIC	P OW EH T IH K
POIGNANT	P OY N Y AH N T
POINT	P OY N T
POINTS	P OY N T S
POISONED	P OY Z AH N D
POKE	P OW K
POLANSKI	P AH L AE N S K IY
POLARIZATION	P OW L ER AH Z EY SH AH N
POLARIZATION(2)	P OW L ER IH Z EY SH AH N
POLICE	P AH L IY S
POLISH	P AA L IH SH
POLISH(2)	P OW L IH SH
POLISHED	P AA L IH SH T
POLITE	P AH L AY T
POLLAK	P AA L AH K
POND	P AA N D
POOR	P UW R
POORLY	P UW R L IY
POP	P AA P
POPCORN	P AA P K AO R N
POPULAR	P AA P Y AH L ER
PORN	P AO R N
PORTRAIT	P AO R T R AH T
PORTRAY	P AO R T R EY
PORTRAYAL	P AO R T R EY AH L
PORTRAYED	P AO R T R EY D
PORTRAYING	P AO R T R EY IH NG
POS	P AA S
POS(2)	P IY OW EH S
POSEY	P OW Z IY
POSITION	P AH Z IH SH AH N
POSITIONED	P AH Z IH SH AH N D
POSITIVE	P AA Z AH T IH V
POSSESS	P AH Z EH S
POSSESSION	P AH Z EH SH AH N
POSSIBILITY	P AA S AH B IH L AH T IY
POSSIBLE	P AA S AH B AH L
POSSIBLY	P AA S AH B L IY
POST	P OW S T
POSTERS	P OW S T ER Z
POSTING	P OW S T IH NG
POTENTIAL	P AH T EH N SH AH L
POW	P AW
POWER	P AW ER
POWERFUL	P AW ER F AH L
POWS	P OW Z
PRAISE	P R EY Z
PRANKS	P R AE NG K S
PRECLUDE	P R IH K L UW D
PRECLUDE(2)	P R IY K L UW D
PREDECESSOR	P R EH D AH S EH S ER
PREDICT	P R IH D IH K T
PREDICT(2)	P R IY D IH K T
PREDICTABLE	P R IH D IH K T AH B AH L
PREDICTABLE(2)	P R IY D IH K T AH B AH L
PREDOMINATELY	P R IH D AA M AH N AH N T L IY
PREFERRED	P R AH F ER D
PREFERRED(2)	P R IH F ER D
PREFERRED(3)	P R IY F ER D
PREGNANT	P R EH G N AH N T
PREMIERE	P R EH M IH R
PREMONITION	P R EH M AH N IH SH AH N
PREPARING	P R IY P EH R IH NG
PREPARING(2)	P ER P EH R IH NG
PRESENCE	P R EH Z AH N S
PRESENT	P R EH Z AH N T
PRESENT(2)	P R IY Z EH N T
PRESENT(3)	P ER Z EH N T
PRESENTATION	P R EH Z AH N T EY SH AH N
PRESENTED	P R IY Z EH N T AH D
PRESENTED(2)	P ER Z EH N T AH D
PRESENTED(3)	P R IY Z EH N AH D
PRESENTED(4)	P ER Z EH N AH D
PRESENTLY	P R EH Z AH N T L IY
PRESENTS	P R EH Z AH N T S
PRESENTS(2)	P R IY Z EH N T S
PRESERVED	P R AH Z ER V D
PRESERVED(2)	P R IH Z ER V D
PRESERVED(3)	P R IY Z ER V D
PRESSURE	P R EH SH ER
PRESTIGIOUS	P R EH S T IH JH AH S
PRESTIGIOUS(2)	P ER S T IY JH AH S
PRESUMABLY	P R AH Z UW M AH B L IY
PRESUMABLY(2)	P R IH Z UW M AH B L IY
PRESUMABLY(3)	P R IY Z UW M AH B L IY
PRETENDING	P R IY T EH N D IH NG
PRETENSIONS	P R AH T EH N SH AH N Z
PRETENTIOUS	P R IY T EH N SH AH S
PRETTY	P R IH T IY
PREVENT	P R IH V EH N T
PREVENT(2)	P R IY V EH N T
PREVIOUS	P R IY V IY AH S
PREY	P R EY
PRICE	P R AY S
PRIMARILY	P R AY M EH R AH L IY
PRIME	P R AY M
PRINCE	P R IH N S
PRINCIPAL	P R IH N S AH P AH L
PRINCIPLE	P R IH N S AH P AH L
PRIOR	P R AY ER
PRISONER	P R IH Z AH N ER
PRISONER(2)	P R IH Z N ER
PRISONERS	P R IH Z AH N ER Z
PRISONERS(2)	P R IH Z N ER Z
PRIZE	P R AY Z
PRO	P R OW
PROBABLY	P R AA B AH B L IY
PROBLEM	P R AA B L AH M
PROBLEMS	P R AA B L AH M Z
PROCESS	P R AA S EH S
PROCESS(2)	P R AO S EH S
PRODUCED	P R AH D UW S T
PRODUCER	P R AH D UW S ER
PRODUCERS	P R AH D UW S ER Z
PRODUCING	P R AH D UW S IH NG
PRODUCT	P R AA D AH K T
PRODUCTION	P R AH D AH K SH AH N
PRODUCTION(2)	P R OW D AH K SH AH N
PRODUCTION(3)	P ER D AH K SH AH N
PRODUCTIONS	P R AH D AH K SH AH N Z
PRODUCTIONS(2)	P R OW D AH K SH AH N Z
PRODUCTIONS(3)	P ER D AH K SH AH N Z
PROFESSIONAL	P R AH F EH SH AH N AH L
PROGRESSES	P R AA G R EH S AH Z
PROGRESSES(2)	P R OW G R EH S AH Z
PROJECTS	P R AA JH EH K T S
PROMISED	P R AA M AH S T
PROMO	P R OW M OW
PRONE	P R OW N
PROPER	P R AA P ER
PROPRIETARY	P R AH P R AY AH T EH R IY
PROSECUTOR	P R AA S IH K Y UW T ER
PROSTHESIS	P R AO S TH EH S IH S
PROSTHESIS(2)	P R AO S TH IY S IH S
PROUSALIS	P R OW Y UW S AH L IY Z
PROVE	P R UW V
PROVIDE	P R AH V AY D
PROVIDES	P R AH V AY D Z
PROVOKE	P R AH V OW K
PSYCHEDELIC	S AY K AH D EH L IH K
PSYCHOLOGICAL	S AY K AH L AA JH IH K AH L
PUBLIC	P AH B L IH K
PUFNSTUF	P AH F N S T AH F
PUGILIST	P Y UW JH AH L IH S T
PUKE	P Y UW K
PULASKY	P Y UW L AE S IY
PULL	P UH L
PULLED	P UH L D
PULLING	P UH L IH NG
PULLS	P UH L Z
PUNCH	P AH N CH
PUNCHING	P AH N CH IH NG
PUNCTUATES	P AH NG K CH AH W AH T S
PURCHASE	P ER CH AH S
PURCHASING	P ER CH AH S IH NG
PURE	P Y UH R
PURISTS	P Y UH R IH S T S
PURSUIT	P ER S UW T
PUSHES	P UH SH AH Z
PUSHES(2)	P UH SH IH Z
PUSHING	P UH SH IH NG
PUT	P UH T
PUTATIVE	P Y UW T AH T IH V
PUTTING	P AH T IH NG
PUTTING(2)	P UH T IH NG
QUALIFYING	K W AA L AH F AY IH NG
QUALITY	K W AA L AH T IY
QUARTER	K W AO R T ER
QUEEN	K W IY N
QUEST	K W EH S T
QUESTION	K W EH S CH AH N
QUESTION(2)	K W EH SH AH N
QUICK	K W IH K
QUICKLY	K W IH K L IY
QUIET	K W AY AH T
QUIRKY	K W ER K IY
QUIT	K W IH T
QUITE	K W AY T
R	AA R
RACE	R EY S
RACIST	R EY S IH S T
RACK	R AE K
RADHA	R AA D AH
RADIO	R EY D IY OW
RAGING	R EY JH IH NG
RAID	R EY D
RAILROAD	R EY L R OW D
RAIN	R EY N
RAINY	R EY N IY
RAJ	R AA ZH
RAJ(2)	R AA JH
RALPH	R AE L F
RAMONES	R AH M OW N Z
RAMOS	R AA M OW S
RAMOS(2)	R EY M OW S
RAN	R AE N
RANDOLPH	R AE N D AA L F
RANDOM	R AE N D AH M
RANDY	R AE N D IY
RANGE	R EY N JH
RAP	R AE P
RAPPERS	R AE P ER Z
RARE	R EH R
RARELY	R EH R L IY
RATE	R EY T
RATED	R EY T AH D
RATED(2)	R EY T IH D
RATHER	R AE DH ER
RATHER(2)	R AH DH ER
RATING	R EY T IH NG
RATINGS	R EY T IH NG Z
RAVES	R EY V Z
RAWKED	R AO K T
RAY	R EY
RAYBURN	R EY B ER N
RAYMOND	R EY M AH N D
RE	R EY
RE(2)	R IY
REACHED	R IY CH T
REACHES	R IY CH AH Z
REACHES(2)	R IY CH IH Z
READ	R EH D
READ(2)	R IY D
READING	R IY D IH NG
READING(2)	R EH D IH NG
READY	R EH D IY
REAL	R IY L
REALISES	R IY AH L AY Z IH Z
REALISTIC	R IY AH L IH S T IH K
REALITIES	R IY AE L AH T IY Z
REALITY	R IY AE L AH T IY
REALIZE	R IY AH L AY Z
REALIZED	R IY AH L AY Z D
REALIZES	R IY AH L AY Z IH Z
REALIZING	R IY AH L AY Z IH NG
REALLY	R IH L IY
REALLY(2)	R IY L IY
REALM	R EH L M
REASON	R IY Z AH N
REASONS	R IY Z AH N Z
REAY	R EY
REBECCA	R AH B EH K AH
REBIRTH	R IY B ER TH
RECEIVED	R AH S IY V D
RECEIVED(2)	R IH S IY V D
RECEIVED(3)	R IY S IY V D
RECENT	R IY S AH N T
RECENTLY	R IY S AH N T L IY
RECENTLY(2)	R IY S AH N L IY
RECIPE	R EH S AH P IY
RECOGNISE	R EH K AH G N AY Z
RECOGNITION	R EH K AH G N IH SH AH N
RECOGNITION(2)	R EH K IH G N IH SH AH N
RECOGNIZED	R EH K AH G N AY Z D
RECOMMEND	R EH K AH M EH N D
RECOMMENDABLE	R EH K AH M EH N D AH B AH L
RECOMMENDATION	R EH K AH M AH N D EY SH AH N
RECOMMENDED	R EH K AH M EH N D AH D
RECOMMENDED(2)	R EH K AH M EH N D IH D
RECOMMENDING	R EH K AH M EH N D IH NG
RECONSIDERED	R IY K AH N S IH D ER D
RECORD	R AH K AO R D
RECORD(2)	R EH K ER D
RECORD(3)	R IH K AO R D
RECORDING	R AH K AO R D IH NG
RECORDING(2)	R IH K AO R D IH NG
RECOVER	R IH K AH V ER
RECOVERED	R AH K AH V ER D
RECOVERED(2)	R IH K AH V ER D
RECYCLED	R IY S AY K AH L D
RED	R EH D
REED	R IY D
REEVE	R IY V
REFRESHING	R IH F R EH SH IH NG
REFUSE	R AH F Y UW Z
REFUSE(2)	R EH F Y UW Z
REFUSE(3)	R IH F Y UW Z
REFUSES	R AH F Y UW Z AH Z
REFUSES(2)	R IH F Y UW Z IH Z
REGARD	R AH G AA R D
REGARD(2)	R IH G AA R D
REGARDED	R AH G AA R D AH D
REGARDED(2)	R IH G AA R D IH D
REGARDING	R AH G AA R D IH NG
REGARDING(2)	R IH G AA R D IH NG
REGULAR	R EH G Y AH L ER
REGULAR(2)	R EY G Y AH L ER
REHASH	R IY HH AE SH
REHEARSING	R IH HH ER S IH NG
REJECTED	R IH JH EH K T IH D
REJECTED(2)	R IY JH EH K T AH D
REJECTED(3)	R IY JH EH K T IH D
RELATE	R IH L EY T
RELATE(2)	R IY L EY T
RELATIONSHIP	R IY L EY SH AH N SH IH P
RELATIONSHIPS	R IY L EY SH AH N SH IH P S
RELATIVELY	R EH L AH T IH V L IY
RELATIVES	R EH L AH T IH V Z
RELEASE	R IY L IY S
RELEASED	R IY L IY S T
RELEASES	R IH L IY S IH Z
RELENTLESS	R IH L EH N T L IH S
RELIANCE	R IH L AY AH N S
RELIANCE(2)	R IY L AY AH N S
RELIC	R EH L IH K
RELIED	R IH L AY D
RELIED(2)	R IY L AY D
RELIEF	R IH L IY F
RELIEF(2)	R IY L IY F
RELIGIOUS	R IH L IH JH AH S
RELIGIOUS(2)	R IY L IH JH AH S
RELISH	R EH L IH SH
RELY	R IH L AY
RELY(2)	R IY L AY
REMAINS	R IH M EY N Z
REMAINS(2)	R IY M EY N Z
REMAKE	R IY M EY K
REMARKABLE	R IH M AA R K AH B AH L
REMARKABLE(2)	R IY M AA R K AH B AH L
REMEMBER	R IH M EH M B ER
REMEMBER(2)	R IY M EH M B ER
REMEMBERED	R IH M EH M B ER D
REMEMBERED(2)	R IY M EH M B ER D
REMIND	R IY M AY N D
REMINDED	R IY M AY N D AH D
REMINDED(2)	R IY M AY N D IH D
REMINDS	R IY M AY N D Z
REMINISCENT	R EH M AH N IH S AH N T
RENAISSANCE	R EH N AH S AA N S
RENDITION	R EH N D IH SH AH N
RENO	R IY N OW
RENOWN	R IH N AW N
RENT	R EH N T
RENTAL	R EH N T AH L
REPEAT	R IH P IY T
REPEAT(2)	R IY P IY T
REPEATED	R IH P IY T IH D
REPEATED(2)	R IY P IY T AH D
REPEATED(3)	R IY P IY T IH D
REPEATING	R IH P IY T IH NG
REPEATING(2)	R IY P IY T IH NG
REPEATS	R IH P IY T S
REPEATS(2)	R IY P IY T S
REPERTORY	R EH P ER T AO R IY
REPLAY	R IY P L EY
REPLIES	R IH P L AY Z
REPLIES(2)	R IY P L AY Z
REPRESENTATION	R EH P R AH Z EH N T EY SH AH N
REPRESSING	R IY P R EH S IH NG
REPRISE	R IH P R AY Z
REPRISE(2)	R IH P R IY Z
REQUIRED	R IY K W AY ER D
REQUIRED(2)	R IY K W AY R D
RESEARCH	R IY S ER CH
RESEMBLING	R IH Z EH M B AH L IH NG
RESEMBLING(2)	R IY Z EH M B AH L IH NG
RESEMBLING(3)	R IY Z EH M B L IH NG
RESERVATIONS	R EH Z ER V EY SH AH N Z
RESIDENCE	R EH Z IH D AH N S
RESIDENT	R EH Z IH D AH N T
RESORT	R IH Z AO R T
RESORT(2)	R IY Z AO R T
RESORT(3)	R IY S AO R T
RESPECTFULLY	R IH S P EH K T F AH L IY
RESPECTS	R IH S P EH K T S
RESPECTS(2)	R IY S P EH K T S
RESPECTS(3)	R AH S P EH K S
RESPECTS(4)	R IY S P EH K S
RESPONSE	R IH S P AA N S
RESPONSE(2)	R IY S P AA N S
RESPONSIBLE	R IY S P AA N S AH B AH L
RESSE	R IH S IY
REST	R EH S T
RESTART	R IY S T AA R T
RESTRAIN	R IY S T R EY N
RESTS	R EH S T S
RESULT	R IH Z AH L T
RESULT(2)	R IY Z AH L T
RESULTED	R IH Z AH L T IH D
RESULTED(2)	R IY Z AH L T AH D
RESULTED(3)	R IY Z AH L T IH D
RESURRECT	R EH Z ER EH K T
RETAINING	R IH T EY N IH NG
RETAINING(2)	R IY T EY N IH NG
RETAKES	R IY T EY K S
RETICENT	R EH T IH S AH N T
RETIRED	R IH T AY R D
RETIRED(2)	R IY T AY ER D
RETIRED(3)	R IY T AY R D
RETIREMENT	R IY T AY ER M AH N T
RETIREMENT(2)	R IH T AY ER M AH N T
RETREAT	R IY T R IY T
RETROSPECT	R EH T R AH S P EH K T
RETURN	R IH T ER N
RETURN(2)	R IY T ER N
RETURNS	R IH T ER N Z
RETURNS(2)	R IY T ER N Z
REVEALING	R IH V IY L IH NG
REVEALING(2)	R IY V IY L IH NG
REVELATIONS	R EH V AH L EY SH AH N Z
REVENGE	R IY V EH N JH
REVIEW	R IY V Y UW
REVIEWED	R IY V Y UW D
REVIEWERS	R IY V Y UW ER Z
REVIVE	R IH V AY V
REVIVE(2)	R IY V AY V
REVIVING	R IH V AY V IH NG
REVIVING(2)	R IY V AY V IH NG
REVOLVING	R IY V AA L V IH NG
REWARDED	R IH W AO R D IH D
REWARDED(2)	R IY W AO R D AH D
REWARDED(3)	R IY W AO R D IH D
REYNOLDS	R EH N AH L D Z
RHYTHM	R IH DH AH M
RHYTHMIC	R IH DH M IH K
RIBBONS	R IH B AH N Z
RICCI	R IY CH IY
RICH	R IH CH
RICHARDSON	R IH CH ER D S AH N
RID	R IH D
RIDDLED	R IH D AH L D
RIDE	R AY D
RIDES	R AY D Z
RIDICULOUS	R IH D IH K Y AH L AH S
RIGHT	R AY T
RING	R IH NG
RINGS	R IH NG Z
RINGWALD	R IH NG W AO L D
RISK	R IH S K
RITA	R IY T AH
RITTER	R IH T ER
RIVAL	R AY V AH L
RIVER	R IH V ER
RIVERSIDE	R IH V ER S AY D
ROAMING	R OW M IH NG
ROBERT	R AA B ER T
ROBIN	R AA B AH N
ROBIN(2)	R AA B IH N
ROBINSON	R AA B AH N S AH N
ROCK	R AA K
ROCKETS	R AA K AH T S
ROCKS	R AA K S
ROCKSTARS	R AA K S T AA R Z
ROCKY	R AA K IY
ROGER	R AA JH ER
ROGERS	R AA JH ER Z
ROLE	R OW L
ROLES	R OW L Z
ROLL	R OW L
ROMANCE	R OW M AE N S
ROMANTIC	R OW M AE N T IH K
ROMANTICS	R OW M AE N T IH K S
ROMEO	R OW M IY OW
RONNY	R AA N IY
ROOKIE	R UH K IY
ROOTED	R UW T AH D
ROOTED(2)	R UW T IH D
ROOTING	R UW T IH NG
ROOTLESS	R UW T L AH S
ROPE	R OW P
ROSE	R OW Z
ROSEANNE	R OW Z AE N
ROUGHLY	R AH F L IY
ROUND	R AW N D
ROUTE	R UW T
ROUTE(2)	R AW T
ROUTINES	R UW T IY N Z
RUIN	R UW AH N
RUIN(2)	R UW IH N
RULED	R UW L D
RULES	R UW L Z
RUNG	R AH NG
RUNNER	R AH N ER
RUNNING	R AH N IH NG
RUNS	R AH N Z
RUSSELL	R AH S AH L
RUSSIAN	R AH SH AH N
S	EH S
SACRIFICE	S AE K R AH F AY S
SAD	S AE D
SADDEST	S AE D AH S T
SADLY	S AE D L IY
SAFE	S EY F
SAGA	S AA G AH
SAHIB	S AE HH AH B
SAID	S EH D
SAILOR	S EY L ER
SALESMAN	S EY L Z M AH N
SAM	S AE M
SAME	S EY M
SAMUEL	S AE M Y UW L
SAN	S AE N
SANDLER	S AE N D L ER
SANT	S AE N T
SARCASTIC	S AA R K AE S T IH K
SAT	S AE T
SATAN	S EY T AH N
SATANIC	S AH T AE N IH K
SATIN	S AE T AH N
SATIRE	S AE T AY ER
SATIRIZING	S AE T ER AY Z IH NG
SATISFY	S AE T AH S F AY
SATISFY(2)	S AE T IH S F AY
SATISFYING	S AE T IH S F AY IH NG
SAVAGE	S AE V AH JH
SAVAGE(2)	S AE V IH JH
SAVED	S EY V D
SAW	S AO
SAY	S EY
SAYING	S EY IH NG
SAYS	S EH Z
SAYS(2)	S IH Z
SCALE	S K EY L
SCARES	S K EH R Z
SCARIEST	S K EH R IY AH S T
SCARY	S K EH R IY
SCENARIO	S IH N EH R IY OW
SCENARIOS	S IH N EH R IY OW Z
SCENE	S IY N
SCENERY	S IY N ER IY
SCENES	S IY N Z
SCENESÂ…	S IY N Z
SCHEDULE	S K EH JH UH L
SCHEDULE(2)	S K EH JH UW L
SCHERLER	S K AH R L AH R
SCHLOCKY	S K L AA K IY
SCHOOL	S K UW L
SCHOOLS	S K UW L Z
SCI	S IY
SCI(2)	EH S S IY AY
SCOOP	S K UW P
SCOPE	S K OW P
SCORCESE	S K AO R S IY Z
SCORE	S K AO R
SCORSESE	S K AO R S IY Z
SCORSESE(2)	S K AO R S EY Z IY
SCOTT	S K AA T
SCRATCHING	S K R AE CH IH NG
SCREAM	S K R IY M
SCREEN	S K R IY N
SCREENPLAY	S K R IY N P L EY
SCREWING	S K R UW IH NG
SCRIPT	S K R IH P T
SCRUTINY	S K R UW T AH N IY
SEA	S IY
SEAN	SH AO N
SEARCHING	S ER CH IH NG
SEASON	S IY Z AH N
SEAT	S IY T
SECOND	S EH K AH N D
SECONDARY	S EH K AH N D EH R IY
SECRET	S IY K R AH T
SECRET(2)	S IY K R IH T
SECRETLY	S IY K R IH T L IY
SEE	S IY
SEED	S IY D
SEEING	S IY IH NG
SEEKS	S IY K S
SEEM	S IY M
SEEMED	S IY M D
SEEMINGLY	S IY M IH NG L IY
SEEMS	S IY M Z
SEEN	S IY N
SEGMENTS	S EH G M AH N T S
SEGMENTS(2)	S EH G M EH N T S
SELDOM	S EH L D AH M
SELF	S EH L F
SELL	S EH L
SELLERS	S EH L ER Z
SENDING	S EH N D IH NG
SENDS	S EH N D Z
SENSE	S EH N S
SENSITIVE	S EH N S AH T IH V
SENSITIVE(2)	S EH N S IH T IH V
SENSITIVELY	S EH N S IH T IH V L IY
SENT	S EH N T
SENTENCED	S EH N T AH N S T
SEPARATE	S EH P ER EY T
SEPARATE(2)	S EH P ER IH T
SEPARATE(3)	S EH P R AH T
SEPARATED	S EH P ER EY T AH D
SEPARATED(2)	S EH P ER EY T IH D
SEPARATING	S EH P ER EY T IH NG
SEQUELS	S IY K W AH L Z
SEQUENCE	S IY K W AH N S
SEQUENCES	S IY K W AH N S AH Z
SEQUENCES(2)	S IY K W AH N S IH Z
SERGEI	S ER G EY
SERGEI(2)	S EH R G EY
SERGO	S AH R G OW
SERIAL	S IH R IY AH L
SERIES	S IH R IY Z
SERIOUS	S IH R IY AH S
SERIOUSLY	S IH R IY AH S L IY
SERVED	S ER V D
SERVICEABLE	S ER V AH S AH B AH L
SESILIA	S AH S IH L Y AH
SET	S EH T
SETS	S EH T S
SETTING	S EH T IH NG
SETTLES	S EH T AH L Z
SETÂ…	S EH T
SEVEN	S EH V AH N
SEVENTIES	S EH V AH N T IY Z
SEVERAL	S EH V ER AH L
SEVERE	S AH V IH R
SEX	S EH K S
SEXUAL	S EH K SH UW AH L
SEXUALLY	S EH K SH UW AH L IY
SEXY	S EH K S IY
SHADES	SH EY D Z
SHADOW	SH AE D OW
SHADOWED	SH AE D OW D
SHADOWS	SH AE D OW Z
SHAKES	SH EY K S
SHAKESPEARE	SH EY K S P IY R
SHALL	SH AE L
SHALLOW	SH AE L OW
SHAME	SH EY M
SHAMELESSLY	SH EY M L AH S L IY
SHANGHAI	SH AE NG HH AY
SHATTERING	SH AE T ER IH NG
SHAW	SH AO
SHE	SH IY
SHEDS	SH EH D Z
SHEPPARD	SH EH P ER D
SHINE	SH AY N
SHIRLEY	SH ER L IY
SHOCK	SH AA K
SHOCKINGLY	SH AA K IH NG L IY
SHOE	SH UW
SHOOTING	SH UW T IH NG
SHOOTS	SH UW T S
SHORE	SH AO R
SHORT	SH AO R T
SHORTENING	SH AO R T AH N IH NG
SHORTENING(2)	SH AO R T N IH NG
SHORTLY	SH AO R T L IY
SHORTS	SH AO R T S
SHOT	SH AA T
SHOTS	SH AA T S
SHOULD	SH UH D
SHOULDERS	SH OW L D ER Z
SHOULDN	SH OW L D N
SHOW	SH OW
SHOWDOWN	SH OW D AW N
SHOWED	SH OW D
SHOWING	SH OW IH NG
SHOWN	SH OW N
SHOWS	SH OW Z
SHRINK	SH R IH NG K
SHRUG	SH R AH G
SHUTTLE	SH AH T AH L
SICK	S IH K
SIDE	S AY D
SIDNEY	S IH D N IY
SIGHT	S AY T
SIGNIFICANCE	S AH G N IH F IH K AH N S
SIGNIFICANCE(2)	S IH G N IH F IH K AH N S
SIGNIFICANT	S AH G N IH F IH K AH N T
SIGNIFICANT(2)	S IH G N IH F IH K AH N T
SIKES	S AY K S
SILENCE	S AY L AH N S
SILENT	S AY L AH N T
SILLY	S IH L IY
SIMILAR	S IH M AH L ER
SIMON	S AY M AH N
SIMPLE	S IH M P AH L
SIMPLIFIED	S IH M P L AH F AY D
SIMPLISTIC	S IH M P L IH S T IH K
SIMPLY	S IH M P L IY
SINATRA	S AH N AA T R AH
SINCE	S IH N S
SINCERELY	S IH N S IH R L IY
SING	S IH NG
SINGER	S IH NG ER
SINGIN	S IH N JH IH N
SINGING	S IH NG IH NG
SINGLE	S IH NG G AH L
SINISTER	S IH N IH S T ER
SIR	S ER
SISSY	S IH S IY
SISTER	S IH S T ER
SISTERS	S IH S T ER Z
SIT	S IH T
SITCOM	S IH T K AA M
SITCOMS	S IH T K AA M Z
SITTING	S IH T IH NG
SITUATED	S IH CH UW EY T IH D
SITUATION	S IH CH UW EY SH AH N
SITUATIONS	S IH CH UW EY SH AH N Z
SIX	S IH K S
SIXTEEN	S IH K S T IY N
SIZED	S AY Z D
SKELETON	S K EH L AH T AH N
SKILLS	S K IH L Z
SKY	S K AY
SKYE	S K AY
SLAPPED	S L AE P T
SLASHER	S L AE SH ER
SLAY	S L EY
SLAYED	S L EY D
SLAYER	S L EY ER
SLAYING	S L EY IH NG
SLEAZIEST	S L IY Z AY AH S T
SLEEPING	S L IY P IH NG
SLIGHTLY	S L AY T L IY
SLIPPED	S L IH P T
SLIPPER	S L IH P ER
SLOAN	S L OW N
SLOANE	S L OW N
SLOW	S L OW
SLOWLY	S L OW L IY
SLYLY	S L AY L IY
SMALL	S M AO L
SMALLER	S M AO L ER
SMART	S M AA R T
SMARTEST	S M AA R T AH S T
SMELL	S M EH L
SMILE	S M AY L
SMILING	S M AY L IH NG
SMITH	S M IH TH
SMOKE	S M OW K
SMOOTH	S M UW DH
SMOOTHLY	S M UW DH L IY
SNAPPED	S N AE P T
SNAPPING	S N AE P IH NG
SNAPSHOT	S N AE P SH AA T
SNAPSHOTS	S N AE P SH AA T S
SNOW	S N OW
SO	S OW
SOAVI	S OW V IY
SOCCER	S AA K ER
SOCIETY	S OW S AY IH T IY
SOCIOPATH	S OW S IY OW P AE TH
SOFIKO	S AA F AH K OW
SOFT	S AA F T
SOFT(2)	S AO F T
SOLDIERS	S OW L JH ER Z
SOME	S AH M
SOMEDAY	S AH M D EY
SOMEHOW	S AH M HH AW
SOMEONE	S AH M W AH N
SOMETHING	S AH M TH IH NG
SOMETIMES	S AH M T AY M Z
SOMEWHAT	S AH M W AH T
SOMEWHAT(2)	S AH M HH W AH T
SON	S AH N
SONG	S AO NG
SONGS	S AO NG Z
SOON	S UW N
SOPHY	S OW F IY
SORE	S AO R
SORROW	S AA R OW
SORRY	S AA R IY
SORT	S AO R T
SORTS	S AO R T S
SOUL	S OW L
SOUND	S AW N D
SOUNDS	S AW N D Z
SOUNDS(2)	S AW N Z
SOUNDTRACK	S AW N D T R AE K
SOUNDTRACK(2)	S AW N T R AE K
SOUR	S AW ER
SOUR(2)	S AW R
SOURCE	S AO R S
SOX	S AA K S
SPACE	S P EY S
SPACED	S P EY S T
SPADES	S P EY D Z
SPEAK	S P IY K
SPEAKS	S P IY K S
SPECIAL	S P EH SH AH L
SPECIALTY	S P EH SH AH L T IY
SPECIALTY(2)	S P EY SH AH L T IY
SPECIFIC	S P AH S IH F IH K
SPECIFIC(2)	S P IH S IH F IH K
SPECTACLE	S P EH K T AH K AH L
SPECTACULAR	S P EH K T AE K Y AH L ER
SPECULATION	S P EH K Y AH L EY SH AH N
SPEECH	S P IY CH
SPEECHES	S P IY CH AH Z
SPEECHES(2)	S P IY CH IH Z
SPELL	S P EH L
SPENCER	S P EH N S ER
SPEND	S P EH N D
SPENT	S P EH N T
SPINE	S P AY N
SPINNING	S P IH N IH NG
SPIRIT	S P IH R AH T
SPIRIT(2)	S P IH R IH T
SPITE	S P AY T
SPLIT	S P L IH T
SPOCK	S P AA K
SPOIL	S P OY L
SPOILING	S P OY L IH NG
SPONTANEOUS	S P AA N T EY N IY AH S
SPOOFING	S P UW F IH NG
SPORTS	S P AO R T S
SPOT	S P AA T
SPOTS	S P AA T S
SPOUSE	S P AW S
SPUR	S P ER
ST	EH S T
STAG	S T AE G
STAGE	S T EY JH
STAGES	S T EY JH IH Z
STAGING	S T EY JH IH NG
STALAG	S T AA L AA G
STAMMERING	S T AE M ER IH NG
STAND	S T AE N D
STANDARD	S T AE N D ER D
STANDARDS	S T AE N D ER D Z
STANDING	S T AE N D IH NG
STANDS	S T AE N D Z
STANWYCK	S T AE N W AH K
STAR	S T AA R
STARK	S T AA R K
STARRED	S T AA R D
STARRING	S T AA R IH NG
STARS	S T AA R Z
START	S T AA R T
STARTED	S T AA R T AH D
STARTED(2)	S T AA R T IH D
STARTING	S T AA R T IH NG
STARTS	S T AA R T S
STATEMENT	S T EY T M AH N T
STATEMENTS	S T EY T M AH N T S
STATING	S T EY T IH NG
STATION	S T EY SH AH N
STAVROS	S T AH V R OW Z
STAY	S T EY
STEAL	S T IY L
STEELE	S T IY L
STEP	S T EH P
STEPHENSON	S T IY V AH N S AH N
STEPSISTERS	S T EH P S IH S T ER Z
STEREOTYPICAL	S T EH R IY OW T IH P IH K AH L
STEVEN	S T IY V AH N
STILL	S T IH L
STILTED	S T IH L T IH D
STOIC	S T OW IH K
STOMACH	S T AH M AH K
STONER	S T OW N ER
STOOD	S T UH D
STOOPID	S T UW P AH D
STOP	S T AA P
STORE	S T AO R
STORIES	S T AO R IY Z
STORY	S T AO R IY
STRAIGHT	S T R EY T
STRAIGHTFORWARD	S T R EY T F AO R W ER D
STRANDED	S T R AE N D AH D
STRANDED(2)	S T R AE N D IH D
STRANGE	S T R EY N JH
STRANGELY	S T R EY N JH L IY
STRAY	S T R EY
STREEP	S T R IY P
STREET	S T R IY T
STREETS	S T R IY T S
STRESS	S T R EH S
STRETCHES	S T R EH CH AH Z
STRETCHES(2)	S T R EH CH IH Z
STRIKES	S T R AY K S
STRONG	S T R AO NG
STRONGLY	S T R AO NG L IY
STRUGGLE	S T R AH G AH L
STRUGGLING	S T R AH G AH L IH NG
STRUGGLING(2)	S T R AH G L IH NG
STRUNG	S T R AH NG
STUCK	S T AH K
STUDENT	S T UW D AH N T
STUDENTS	S T UW D AH N T S
STUDIED	S T AH D IY D
STUDIO	S T UW D IY OW
STUDIOS	S T UW D IY OW Z
STUDY	S T AH D IY
STUDYING	S T AH D IY IH NG
STUFF	S T AH F
STUNNING	S T AH N IH NG
STUNNINGLY	S T AH N IH NG L IY
STUNT	S T AH N T
STUPID	S T UW P AH D
STUPID(2)	S T UW P IH D
STUPIDLY	S T UW P AH D L IY
STYLE	S T AY L
STYLED	S T AY L D
STYLES	S T AY L Z
STYLISED	S T AY L IY Z D
STYLISH	S T AY L IH SH
STYLISTIC	S T AY L IH S T IH K
STYLIZATIONS	S T AY L AH Z EY SH AH N Z
SUBCONSCIOUSLY	S AH B K AA N SH AH S L IY
SUBLIME	S AH B L AY M
SUBPLOT	S AH B P L AA T
SUBSEQUENT	S AH B S AH K W AH N T
SUBTITLED	S AH B T AY T AH L D
SUBTITLES	S AH B T AY T AH L Z
SUBTLE	S AH T AH L
SUBTRACT	S AH B T R AE K T
SUBURBAN	S AH B ER B AH N
SUCCEEDING	S AH K S IY D IH NG
SUCCESS	S AH K S EH S
SUCCESSFUL	S AH K S EH S F AH L
SUCCESSFULLY	S AH K S EH S F AH L IY
SUCCUMBED	S AH K AH M D
SUCH	S AH CH
SUCK	S AH K
SUDDENLY	S AH D AH N L IY
SUGGEST	S AH JH EH S T
SUICIDE	S UW AH S AY D
SUICIDE(2)	S UW IH S AY D
SUIT	S UW T
SUITABLE	S UW T AH B AH L
SUITS	S UW T S
SULKY	S AH L K IY
SUM	S AH M
SUMMARY	S AH M ER IY
SUMMERTIME	S AH M ER T AY M
SUMMING	S AH M IH NG
SUMPTUOUS	S AH M P CH W AH S
SUMPTUOUS(2)	S AH M P CH UW AH S
SUNG	S AH NG
SUNRISE	S AH N R AY Z
SUPERB	S UH P ER B
SUPERBLY	S UW P ER B L IY
SUPERIOR	S UW P IH R IY ER
SUPERSTAR	S UW P ER S T AA R
SUPERSTARDOM	S UW P ER S T AA R D AH M
SUPPORT	S AH P AO R T
SUPPORTING	S AH P AO R T IH NG
SUPPOSE	S AH P OW Z
SUPPOSED	S AH P OW Z D
SUPPOSEDLY	S AH P OW Z AH D L IY
SUPREMELY	S UW P R IY M AH L IY
SURE	SH UH R
SURELY	SH UH R L IY
SURFACE	S ER F AH S
SURPASSES	S ER P AE S IH Z
SURPRISE	S ER P R AY Z
SURPRISE(2)	S AH P R AY Z
SURPRISED	S ER P R AY Z D
SURPRISED(2)	S AH P R AY Z D
SURPRISES	S ER P R AY Z IH Z
SURPRISES(2)	S AH P R AY Z IH Z
SURPRISINGLY	S ER P R AY Z IH NG L IY
SURPRISINGLY(2)	S AH P R AY Z IH NG L IY
SURREAL	S ER IY L
SURROUNDED	S ER AW N D AH D
SURROUNDED(2)	S ER AW N D IH D
SURROUNDING	S ER AW N D IH NG
SURROUNDINGS	S ER AW N D IH NG Z
SURVIVING	S ER V AY V IH NG
SUSPECT	S AH S P EH K T
SUSPENSE	S AH S P EH N S
SUSPENSEFUL	S AH S P EH N S F AH L
SUSSANAH	S AH S AH N AH
SUZANNE	S UW Z AE N
SWEARS	S W EH R Z
SWEATER	S W EH T ER
SWEDEN	S W IY D AH N
SWEEPS	S W IY P S
SWEET	S W IY T
SWEETHEART	S W IY T HH AA R T
SWEETLY	S W IY T L IY
SWIFT	S W IH F T
SWIFTLY	S W IH F T L IY
SWING	S W IH NG
SWORD	S AO R D
SWORDPLAY	S AO R D P L EY
SWORDSMAN	S OW R D Z M AE N
SWORDSMANS	S OW R D Z M AE N Z
SYMBOLISM	S IH M B AH L IH Z AH M
SYMPATHETIC	S IH M P AH TH EH T IH K
SYMPATHIZE	S IH M P AH TH AY Z
SYSTEM	S IH S T AH M
SZWARC	S Z W AO R K
T	T IY
TABOO	T AE B UW
TACKY	T AE K IY
TAFT	T AE F T
TAIWANESE	T AY W AA N IY Z
TAKAISHVILI	T AH K EY SH V AH L IY
TAKE	T EY K
TAKEN	T EY K AH N
TAKES	T EY K S
TAKING	T EY K IH NG
TAKITA	T AE K AH T AH
TALE	T EY L
TALENT	T AE L AH N T
TALENTED	T AE L AH N T AH D
TALENTED(2)	T AE L AH N T IH D
TALES	T EY L Z
TALESPIN	T EY L S P IH N
TALK	T AO K
TALKING	T AO K IH NG
TALKS	T AO K S
TARGET	T AA R G AH T
TARGET(2)	T ER G AH T
TARGETED	T AA R G AH T IH D
TASK	T AE S K
TASTELESS	T EY S T L AH S
TAUT	T AO T
TEACHES	T IY CH AH Z
TEACHES(2)	T IY CH IH Z
TEAM	T IY M
TEAMMATE	T IY M EY T
TEAMS	T IY M Z
TEAMWORK	T IY M W ER K
TEAR	T EH R
TEAR(2)	T IH R
TEARS	T EH R Z
TEARS(2)	T IH R Z
TEDIOUS	T IY D IY AH S
TEDIUM	T IY D IY AH M
TEEN	T IY N
TEENAGE	T IY N EY JH
TEENAGER	T IY N EY JH ER
TEENAGERS	T IY N EY JH ER Z
TEENS	T IY N Z
TELESCOPE	T EH L AH S K OW P
TELEVISION	T EH L AH V IH ZH AH N
TELL	T EH L
TELLING	T EH L IH NG
TELLS	T EH L Z
TEMPLE	T EH M P AH L
TEMPO	T EH M P OW
TEN	T EH N
TENANT	T EH N AH N T
TEND	T EH N D
TENDED	T EH N D AH D
TENDED(2)	T EH N D IH D
TENDENCY	T EH N D AH N S IY
TENSE	T EH N S
TENSION	T EH N SH AH N
TEPID	T EH P IH D
TERM	T ER M
TERMED	T ER M D
TERMINALLY	T ER M AH N AH L IY
TERRIBLE	T EH R AH B AH L
TERRIFIC	T ER IH F IH K
TERRIFYING	T EH R AH F AY IH NG
TESTAMENTS	T EH S T AH M AH N T S
TESTING	T EH S T IH NG
TEXTURED	T EH K S CH ER D
TH	T IY EY CH
THAN	DH AE N
THAN(2)	DH AH N
THANK	TH AE NG K
THANKFULLY	TH AE NG K F AH L IY
THANKS	TH AE NG K S
THAT	DH AE T
THAT(2)	DH AH T
THAW	TH AO
THE	DH AH
THE(2)	DH IY
THEATER	TH IY EY T ER
THEATERS	TH IY AH T ER Z
THEATRICAL	TH IY AE T R IH K AH L
THEE	DH IY
THEIR	DH EH R
THEM	DH EH M
THEM(2)	DH AH M
THEME	TH IY M
THEMED	TH IY M D
THEMES	TH IY M Z
THEMSELVES	DH EH M S EH L V Z
THEMSELVES(2)	DH AH M S EH L V Z
THEN	DH EH N
THERE	DH EH R
THEREFORE	DH EH R F AO R
THESE	DH IY Z
THEY	DH EY
THICKENS	TH IH K AH N Z
THIN	TH IH N
THING	TH IH NG
THINGS	TH IH NG Z
THINK	TH IH NG K
THINKING	TH IH NG K IH NG
THIRD	TH ER D
THIRST	TH ER S T
THIRTY	TH ER D IY
THIS	DH IH S
THOMAS	T AA M AH S
THOMPSON	T AA M P S AH N
THOMPSON(2)	T AA M S AH N
THOROUGH	TH ER OW
THOROUGH(2)	TH AO R OW
THOSE	DH OW Z
THOUGH	DH OW
THOUGHT	TH AO T
THOUGHTFUL	TH AO T F AH L
THREAT	TH R EH T
THREATENED	TH R EH T AH N D
THREE	TH R IY
THRILLED	TH R IH L D
THRILLER	TH R IH L ER
THRILLERS	TH R IH L ER Z
THRILLING	TH R IH L IH NG
THROUGH	TH R UW
THROUGHOUT	TH R UW AW T
THROW	TH R OW
THROWING	TH R OW IH NG
THROWN	TH R OW N
THUMBING	TH AH M IH NG
THUMBS	TH AH M Z
THUS	DH AH S
TICKETS	T IH K AH T S
TICKETS(2)	T IH K IH T S
TIED	T AY D
TIGHTLY	T AY T L IY
TILL	T IH L
TIME	T AY M
TIMES	T AY M Z
TIMING	T AY M IH NG
TIMOTHY	T IH M AH TH IY
TINGLER	T IH NG G AH L ER
TINGLER(2)	T IH NG G L ER
TIRE	T AY ER
TITLE	T AY T AH L
TITLES	T AY T AH L Z
TO	T UW
TO(2)	T IH
TO(3)	T AH
TOBY	T OW B IY
TODAY	T AH D EY
TODAY(2)	T UW D EY
TOGETHER	T AH G EH DH ER
TOILET	T OY L AH T
TOKYO	T OW K IY OW
TOLD	T OW L D
TOM	T AA M
TOMMY	T AA M IY
TONE	T OW N
TONGUE	T AH NG
TONGUES	T AH NG Z
TONI	T OW N IY
TONY	T OW N IY
TOO	T UW
TOOK	T UH K
TOOLS	T UW L Z
TOP	T AA P
TOP(2)	T AO P
TOPICS	T AA P IH K S
TORN	T AO R N
TOSS	T AO S
TOTAL	T OW T AH L
TOTALLY	T OW T AH L IY
TOUCH	T AH CH
TOUCHES	T AH CH AH Z
TOUCHES(2)	T AH CH IH Z
TOUCHING	T AH CH IH NG
TOUGH	T AH F
TOURIST	T UH R AH S T
TOURIST(2)	T UH R IH S T
TOW	T OW
TOWARD	T AH W AO R D
TOWARD(2)	T AO R D
TOWN	T AW N
TRACE	T R EY S
TRACK	T R AE K
TRADITIONS	T R AH D IH SH AH N Z
TRAGEDY	T R AE JH AH D IY
TRAGIC	T R AE JH IH K
TRAIN	T R EY N
TRAINED	T R EY N D
TRAIT	T R EY T
TRANS	T R AE N Z
TRANSCEND	T R AE N S EH N D
TRANSFORMS	T R AE N S F AO R M Z
TRANSGRESSIONS	T R AE N Z G R EH SH AH N Z
TRANSLATION	T R AE N Z L EY SH AH N
TRANSLATION(2)	T R AE N S L EY SH AH N
TRANSVESTITISM	T R AE N Z EH S T AH T IH Z AH M
TRAP	T R AE P
TRAPPED	T R AE P T
TRAUMA	T R AO M AH
TRAUMATIZED	T R AO M AH T AY Z D
TRAVEL	T R AE V AH L
TRAVELED	T R AE V AH L D
TRAVELER	T R AE V AH L ER
TRAVELER(2)	T R AE V L ER
TRAVELING	T R AE V AH L IH NG
TRAVELING(2)	T R AE V L IH NG
TRAVIS	T R AE V IH S
TREACHEROUS	T R EH CH ER AH S
TREASURE	T R EH ZH ER
TREAT	T R IY T
TREATED	T R IY T AH D
TREATED(2)	T R IY T IH D
TREATING	T R IY T IH NG
TREATS	T R IY T S
TREK	T R EH K
TRELKOVSKY	T R EH L K AA V S K IY
TREMAINE	T R IH M EY N
TREMENDOUS	T R AH M EH N D AH S
TREMENDOUS(2)	T R IH M EH N D AH S
TRIAD	T R AY AE D
TRIADS	T R AY AE D Z
TRIANGLE	T R AY AE NG G AH L
TRIBUTE	T R IH B Y UW T
TRICKS	T R IH K S
TRIED	T R AY D
TRIES	T R AY Z
TRIFIRI	T R IH F AH R IY
TRIFLE	T R AY F AH L
TRIP	T R IH P
TROJAN	T R OW JH AH N
TROUBLE	T R AH B AH L
TROUBLED	T R AH B AH L D
TRUCK	T R AH K
TRUE	T R UW
TRULY	T R UW L IY
TRUST	T R AH S T
TRUSTS	T R AH S T S
TRUTH	T R UW TH
TRUTHS	T R UW TH S
TRY	T R AY
TRYING	T R AY IH NG
TRYING(2)	T R AY NG
TSUBAKI	T S UW B AH K IY
TUBE	T UW B
TUBE(2)	T Y UW B
TUCCI	T UW CH IY
TUESDAY	T UW Z D IY
TUESDAY(2)	T UW Z D EY
TUESDAY(3)	T Y UW Z D EY
TUMULTUOUS	T UW M AH L CH UW AH S
TUNES	T UW N Z
TUNNEL	T AH N AH L
TUNNELS	T AH N AH L Z
TURKEY	T ER K IY
TURKISH	T ER K IH SH
TURMOIL	T ER M OY L
TURN	T ER N
TURNING	T ER N IH NG
TURNS	T ER N Z
TV	T IY V IY
TV(2)	T EH L AH V IH ZH AH N
TWELVE	T W EH L V
TWENTY	T W EH N T IY
TWICE	T W AY S
TWIST	T W IH S T
TWISTS	T W IH S T S
TWO	T UW
TYPE	T AY P
TYPICAL	T IH P AH K AH L
TYPICAL(2)	T IH P IH K AH L
TYPICALLY	T IH P IH K L IY
TYPICALLY(2)	T IH P IH K AH L IY
TYRANT	T AY R AH N T
UC	AH K
ULTIMATE	AH L T AH M AH T
ULTIMATELY	AH L T AH M AH T L IY
ULTRA	AH L T R AH
UNAPPEALING	AH N AH P IY L IH NG
UNCERTAINTY	AH N S ER T AH N T IY
UNCLE	AH NG K AH L
UNCOMFORTABLE	AH N K AH M F ER T AH B AH L
UNDER	AH N D ER
UNDERACHIEVING	AH N D ER AH CH IY V IH NG
UNDERCOVER	AH N D ER K AH V ER
UNDERHAND	AH N D ER HH AE N D
UNDERLYING	AH N D ER L AY IH NG
UNDERRATED	AH N D ER R EY T IH D
UNDERSTAND	AH N D ER S T AE N D
UNDERSTANDS	AH N D ER S T AE N D Z
UNDERSTATED	AH N D ER S T EY T IH D
UNDERWATER	AH N D ER W AO T ER
UNDERWHELMED	AH N D ER W EH L M D
UNDOUBTEDLY	AH N D AW T IH D L IY
UNEVEN	AH N IY V AH N
UNEXPECTED	AH N IH K S P EH K T IH D
UNEXPECTEDLY	AH N IH K S P EH K T IH D L IY
UNFAIR	AH N F EH R
UNFAIR(2)	AO N F EH R
UNFAIRLY	AH N F EH R L IY
UNFAITHFUL	AH N F EY TH F AH L
UNFOLDING	AH N F OW L D IH NG
UNFOLDS	AH N F OW L D Z
UNFORGETTABLE	AH N F ER G EH T AH B AH L
UNFORTUNATELY	AH N F AO R CH AH N AH T L IY
UNFORTUNATELY(2)	AH N F AO R CH UW N AH T L IY
UNHOLY	AH N HH OW L IY
UNINSPIRED	AH N IH N S P AY ER D
UNINTENTIONALLY	AH N IH N T EH N SH AH N AH L IY
UNINTENTIONALLY(2)	AH N IH N T EH N SH N AH L IY
UNIONS	Y UW N Y AH N Z
UNIQUE	Y UW N IY K
UNIT	Y UW N AH T
UNIT(2)	Y UW N IH T
UNIVERSE	Y UW N AH V ER S
UNKNOWN	AH N N OW N
UNLESS	AH N L EH S
UNLIKABLE	AH N L AY K AH B AH L
UNLIKE	AH N L AY K
UNNECESSARY	AH N N EH S AH S EH R IY
UNNERVING	AH N ER V IH NG
UNOFFICIAL	AH N AH F IH SH AH L
UNREAL	AH N R IY L
UNSETTLING	AH N S EH T AH L IH NG
UNSETTLING(2)	AH N S EH T L IH NG
UNSTABLE	AH N S T EY B AH L
UNSURPASSED	AH N S ER P AE S T
UNTAMED	AH N T EY M D
UNTIL	AH N T IH L
UNUSUAL	AH N Y UW ZH UW AH L
UNUSUAL(2)	AH N Y UW ZH W AH L
UNWILLINGNESS	AH N W IH L IH NG N IH S
UP	AH P
UPDATE	AH P D EY T
UPON	AH P AA N
UPS	AH P S
UPSET	AH P S EH T
URBAN	ER B AH N
URBANE	ER B EY N
URDHU	AH R D HH UW
URGENCY	ER JH AH N S IY
US	AH S
US(2)	Y UW EH S
USA	Y UW EH S EY
USAF	Y UW S AH F
USED	Y UW Z D
USELESS	Y UW S L AH S
USER	Y UW Z ER
USES	Y UW S AH Z
USES(2)	Y UW S IH Z
USES(3)	Y UW Z AH Z
USES(4)	Y UW Z IH Z
USING	Y UW Z IH NG
USUAL	Y UW ZH AH W AH L
USUAL(2)	Y UW ZH UW AH L
USUALLY	Y UW ZH AH W AH L IY
USUALLY(2)	Y UW ZH AH L IY
VACATION	V EY K EY SH AH N
VACHTANGI	V AE CH T AE N JH IY
VAL	V AE L
VALENTINE	V AE L AH N T AY N
VALID	V AE L IH D
VALUE	V AE L Y UW
VAMPIRE	V AE M P AY R
VAMPIRISM	V AE M P AY ER IH Z AH M
VAN	V AE N
VANCE	V AE N S
VAPORIZES	V EY P ER AY Z IH Z
VARIATIONS	V EH R IY EY SH AH N Z
VARIETY	V ER AY AH T IY
VARIOUS	V EH R IY AH S
VARYING	V EH R IY IH NG
VASSILIS	V AE S AH L AH S
VAULTED	V AO L T IH D
VAULTING	V AO L T IH NG
VE	V IY
VEHICLE	V IY HH IH K AH L
VEHICLE(2)	V IY IH K AH L
VEIL	V EY L
VENEZUELA	V EH N IH Z W EY L AH
VERBAL	V ER B AH L
VERGE	V ER JH
VERIKOAN	V AH R IH K OW AH N
VERSED	V ER S T
VERSION	V ER ZH AH N
VERSIONS	V ER ZH AH N Z
VERY	V EH R IY
VIA	V AY AH
VIA(2)	V IY AH
VIBRATORS	V AY B R AH T ER Z
VICISSITUDES	V IH S IH S IH T UW D Z
VICTIM	V IH K T IH M
VICTORY	V IH K T AH R IY
VIDEO	V IH D IY OW
VIE	V AY
VIENNA	V IY EH N AH
VIES	V AY Z
VIETNAM	V IY EH T N AA M
VIEW	V Y UW
VIEWED	V Y UW D
VIEWER	V Y UW ER
VIEWERS	V Y UW ER Z
VIEWING	V Y UW IH NG
VIEWINGS	V Y UW IH NG Z
VIEWS	V Y UW Z
VILLA	V IH L AH
VILLAIN	V IH L AH N
VILLAINS	V IH L AH N Z
VINCENTE	V IH N CH EH N T IY
VINGANÃ§A	V IH N G AH N AH
VIOLENCE	V AY AH L AH N S
VIOLENT	V AY AH L AH N T
VIRILE	V IH R AH L
VISION	V IH ZH AH N
VISIONARY	V IH ZH AH N EH R IY
VISIONS	V IH ZH AH N Z
VISIT	V IH Z IH T
VISUALLY	V IH ZH W AH L IY
VISUALS	V IH ZH W AH L Z
VITAL	V AY T AH L
VOCAL	V OW K AH L
VOICE	V OY S
VOIGHT	V OY T
VOLUME	V AA L Y UW M
VOLUNTEER	V AA L AH N T IH R
VOLUNTEERING	V AO L AH N T IH R IH NG
VON	V AO N
VOTE	V OW T
VOYAGE	V OY AH JH
VS	V ER S AH Z
VU	V UW
VULNERABILITY	V AH L N ER AH B IH L IH T IY
VULNERABLE	V AH L N ER AH B AH L
WAITING	W EY T IH NG
WAKE	W EY K
WALKEN	W AO K AH N
WALKING	W AO K IH NG
WALSH	W AO L SH
WANG	W AE NG
WANT	W AA N T
WANT(2)	W AO N T
WANTED	W AO N T IH D
WANTING	W AA N T IH NG
WANTING(2)	W AA N IH NG
WANTS	W AA N T S
WANTS(2)	W AO N T S
WAR	W AO R
WARDEN	W AO R D AH N
WARDENS	W AO R D AH N Z
WARMING	W AO R M IH NG
WARN	W AO R N
WARNING	W AO R N IH NG
WARRIORS	W AO R IY ER Z
WARRIORS(2)	W AO R Y ER Z
WARS	W AO R Z
WAS	W AA Z
WASH	W AA SH
WASHINGTON	W AA SH IH NG T AH N
WASHINGTON(2)	W AO SH IH NG T AH N
WASN	W AA Z N
WASTE	W EY S T
WATCH	W AA CH
WATCH(2)	W AO CH
WATCHABLE	W AA CH AH B AH L
WATCHED	W AA CH T
WATCHED(2)	W AO CH T
WATCHES	W AA CH AH Z
WATCHES(2)	W AA CH IH Z
WATCHING	W AA CH IH NG
WATCHWORD	W AA CH W ER D
WATER	W AO T ER
WATERS	W AO T ER Z
WAY	W EY
WAYNE	W EY N
WAYS	W EY Z
WE	W IY
WEAK	W IY K
WEAKNESS	W IY K N AH S
WEAKNESSES	W IY K N AH S IH Z
WEALTHY	W EH L TH IY
WEBER	W EH B ER
WEEK	W IY K
WEEKS	W IY K S
WEIRD	W IH R D
WEIRDLY	W IH R D L IY
WEIRDNESS	W IH R D N AH S
WELCOMED	W EH L K AH M D
WELD	W EH L D
WELL	W EH L
WELLES	W EH L Z
WELLS	W EH L Z
WENT	W EH N T
WERCHING	W AH R CH AH NG
WERE	W ER
WEREN	W IY R AH N
WESTERN	W EH S T ER N
WESTERN(2)	HH W EH S T ER N
WESTPOINT	W EH S T P OY N T
WET	W EH T
WHA	W AA
WHAT	W AH T
WHAT(2)	HH W AH T
WHATEVER	W AH T EH V ER
WHATEVER(2)	HH W AH T EH V ER
WHATSOEVER	W AH T S OW EH V ER
WHATSOEVER(2)	HH W AH T S OW EH V ER
WHEN	W EH N
WHEN(2)	HH W EH N
WHEN(3)	W IH N
WHEN(4)	HH W IH N
WHERE	W EH R
WHERE(2)	HH W EH R
WHETHER	W EH DH ER
WHETHER(2)	HH W EH DH ER
WHICH	W IH CH
WHICH(2)	HH W IH CH
WHILE	W AY L
WHILE(2)	HH W AY L
WHILST	W AY L S T
WHIMSICAL	W IH M Z IH K AH L
WHIMSICAL(2)	HH W IH M Z IH K AH L
WHISPER	W IH S P ER
WHISPER(2)	HH W IH S P ER
WHITE	W AY T
WHITE(2)	HH W AY T
WHO	HH UW
WHOA	W OW
WHOA(2)	HH W OW
WHOA(3)	HH OW
WHOEVER	HH UW EH V ER
WHOLE	HH OW L
WHOM	HH UW M
WHOSE	HH UW Z
WHY	W AY
WHY(2)	HH W AY
WICKED	W IH K AH D
WICKEDLY	W IH K IH D L IY
WIDE	W AY D
WIFE	W AY F
WILD	W AY L D
WILDERNESSÂ…	W IH L D ER N AH S
WILDLIFE	W AY L D L AY F
WILL	W IH L
WILL(2)	W AH L
WILLIAM	W IH L Y AH M
WILLIAMS	W IH L Y AH M Z
WILLS	W IH L Z
WIN	W IH N
WINCHESTER	W IH N CH EH S T ER
WINCING	W IH N S IH NG
WIND	W AY N D
WIND(2)	W IH N D
WINDMILL	W IH N D M IH L
WINGS	W IH NG Z
WINNING	W IH N IH NG
WINTER	W IH N T ER
WIRE	W AY ER
WIRE(2)	W AY R
WISDOM	W IH Z D AH M
WISE	W AY Z
WISEMAN	W AY Z M AH N
WISH	W IH SH
WISHED	W IH SH T
WITCH	W IH CH
WITCHCRAFT	W IH CH K R AE F T
WITCHES	W IH CH AH Z
WITCHES(2)	W IH CH IH Z
WITH	W IH DH
WITH(2)	W IH TH
WITHERSPOON	W IH DH ER S P UW N
WITHIN	W IH DH IH N
WITHIN(2)	W IH TH IH N
WITHOUT	W IH TH AW T
WITHOUT(2)	W IH DH AW T
WITTY	W IH T IY
WOLFE	W UH L F
WOMAN	W UH M AH N
WOMEN	W IH M AH N
WON	W AH N
WON(2)	W AA N
WONDER	W AH N D ER
WONDERED	W AH N D ER D
WONDERFUL	W AH N D ER F AH L
WONDERFULLY	W AH N D ER F AH L IY
WONDERFULLY(2)	W AH N D ER F L IY
WONDERING	W AH N D ER IH NG
WONDERLAND	W AH N D ER L AE N D
WONDERS	W AH N D ER Z
WONT	W OW N T
WOODEN	W UH D AH N
WOODS	W UH D Z
WORD	W ER D
WORDS	W ER D Z
WORK	W ER K
WORKED	W ER K T
WORKING	W ER K IH NG
WORKS	W ER K S
WORLD	W ER L D
WORLDLIER	W ER L D L IY ER
WORRY	W ER IY
WORST	W ER S T
WORTH	W ER TH
WORTHWHILE	W ER TH W AY L
WOULD	W UH D
WOULDN	W OW L D N
WOUND	W AW N D
WOUND(2)	W UW N D
WOURNOW	W AH R N OW
WOVEN	W OW V AH N
WOW	W AW
WRAPPED	R AE P T
WRENCHING	R EH N CH IH NG
WRITER	R AY T ER
WRITERS	R AY T ER Z
WRITING	R AY T IH NG
WRITTEN	R IH T AH N
WRONG	R AO NG
WROTE	R OW T
WROUGHT	R AO T
WWI	W IY
WYOMING	W AY OW M IH NG
X	EH K S
XVICHIA	Z V IH CH IY AH
YAHOO	Y AA HH UW
YALL	Y AE L
YANK	Y AE NG K
YANKEE	Y AE NG K IY
YEAH	Y AE
YEAR	Y IH R
YEARS	Y IH R Z
YELL	Y EH L
YEP	Y EH P
YES	Y EH S
YET	Y EH T
YOAKAM	Y OW K AH M
YOJIRO	Y AA JH AH R OW
YORK	Y AO R K
YOU	Y UW
YOUNG	Y AH NG
YOUNGER	Y AH NG G ER
YOUR	Y AO R
YOUR(2)	Y UH R
YOURSELF	Y ER S EH L F
YOURSELF(2)	Y UH R S EH L F
YOURSELF(3)	Y AO R S EH L F
YR	Y R
ZAKARIADZE	Z AH K AE R IY AH D Z
ZAKU	Z AE K UW
ZED	Z EH D
ZEITGEIST	T S AY T G AY S T
ZELAH	Z EH L AH
ZEON	Z IY AH N
ZOMBI	Z AA M B IY
ZOMBIE	Z AA M B IY
ZONE	Z OW N
ZONES	Z OW N Z
