""42ND	F OW R T UW EH N D IY
""A	AH
""AH,	AA
""ALL	AO L
""AMELIE""'S	AH M IY L AY S
""ANY""	EH N IY
""ART""	AA R T
""ARTEMISIA""	AA R T AH M IH ZH IY AH
""AVERAGE""	AE V R IH JH
""BEING	B IY IH NG
""BERNIE""	B IH R N AY
""BLAXPLOITATION""	B L AE K S L OY T EY SH AH N
""BOB""	B AA B
""BREAKER	B R EY K ER
""BUCKET	B AH K AH T
""BUT	B AH T
""CHAMAS	CH AE M AH Z
""CHEERLEADER""...ETC.	CH IH ER L IY D ER EH T
""CONSULATE""	K AA N S AH L AH T
""CUTE""	K Y UW T
""DELIVERANCE""	D IH L IH V ER AH N S
""DEMON	D IY M AH N
""DEMONS	D IY M AH N Z
""DEMONS""	D IY M AH N Z
""FUNNY	F AH N IY
""GAMIN""	G AE M AH N
""GEEK""	JH IY K
""GET	G EH T
""GIG	G IH G
""GOLD	G OW L D
""GOOD	G UH D
""GOODNESS,	G UH D N AH S
""HURRICANE"",	HH ER AH K EY N
""I	AY
""I'M	AY M
""IMPRESSION""	IH M P R EH SH AH N
""IT	IH T
""JOCK""	JH AA K
""LA	L AA
""LET'S	L EH T S
""MAN	M AE N
""MOVIE""	M UW V IY
""MR.MUMBLES""	M R M AH M B AH L Z
""MUMBLES""	M AH M B AH L Z
""MY	M AY
""ON.""	AO N
""RAIN	R EY N
""REAL""	R IY L
""REAL"".	R IY L
""SHOWDOWN""	SH OW D AW N
""SINGIN'	S IH N JH AH N
""THE	DH AH
""THIS	DH IH S
""THRILLER"",	TH R IH L ER
""TOM	T AA M
""UNREAL""	AH N R IY L
""WELL	W EH L
""WHO""	HH UW
""WHO'S	HH UW Z
""WHY	W AY
""WINGS"",	W IH NG Z
""YES""	Y EH S
#1	W AH N
$8	EY T
&	
'30'S	L EH T AH R TH R IY Z IY R OW L EH T AH R EH S
'40'S	L EH T AH R F OW R Z IY R OW L EH T AH R EH S
'73.	L EH T AH R S EH V AH N TH R IY
'A	AA
'BLADE	B L EY D
'BOSS'	B AA Z AH Z
'CHAIRMAN'	CH AE AH R M AH N
'CLEAN'	K L IY N
'COLORIZATION'	K AA L AH R AH Z EY T IY AH N
'COME	K OW M
'EXPERIENCED'	EH K S AH R IY N S AH D
'FAIRY'	F AE AH R AH
'GANGSTER'	G AE N G S T AH R
'GREAT'---THIS	G R IY T
'GUARONTEE'---OVERALL,	G Y UW AE R AH N T IY
'GUILTY'	G UW L T AH
'I	IY
'INTERESTING'	IH N T AH R EH S T AH N G
'JOHN	JH AA N
'LIFE	L AY F
'MAGNETIC-CANNON',	M AE G N AH T AH K K AE N AH N
'MASS-DRIVER'	M AE S D R AY V ER
'MEDAL	M EH D AH L
'MEDIA-QUALITY'	M IY D IY AH K W AA L AH T IY
'MOOD'---WHATEVER	M UW D
'NEVER-TO-BE-MATCHED'	N IY V AH R T UW B IY M AE CH T
'OVER-BUDGET'---SO	OW V AH R B AH JH IH T
'PASSWORTHY'	P AE S W AH R TH AH
'PHONY-PARACHUTING',	F AA N IY P AE R AH CH UW T AH N G
'PROPRIETARY'	P R AA P R IY T AH R AH
'RAP',	R AE P
'RELIC',	R EH L AH K
'REMIND	R AH M AY N D
'SOFT'	S AA F T
'STANDARD	S T AE N D AH R D
'STAR	S T AA R
'SURVIVING'	S AH R V AH V AH N G
'THE	DH
'VERY	V R IY
'WE	W
'WE'RE	W EH R
'WHICH	W HH IH CH
'YES,	AY Z
'YET	AY AH T
(""FLAMES	F L EY M Z
(""GET	G EH T
(""NO	N OW
(8/10)",8,POS	EY T W AH N Z IY R OW EY T P IY OW EH S
(=	
(A	AH
(ACTUALLY,	AE K CH AH W AH L IY
(ALTHOUGH,	AO L DH OW
(AND	AE N D
(ANT1)	EY EH N T IY W AH N
(APART	AH P AA R T
(AS	AE Z
(AT	AE T
(BILLIE	B IH L IY
(BRAZIL):	B R AH Z IH L
(BURT	B AH R T
(CHRISTOPHER	K R IH S T AH F AH R
(CITIZEN	S IH T AH Z AH N
(CONVENTIONALLY)GOOD	K AA N V AH N CH AH N AH L IY G UH D
(DAKOTA	D AE K AH T AH
(DENNIS	D EH N IY Z
(DENZEL	D IH N Z EH L
(EAZY	IY Z IY
(EVEN	IY V AH N
(FATHER	F AA DH ER
(FOR	F AO R
(GIANCARLO	JH AY AH NG K AA R L OW
(GLENN	G L EH N
(HBO?)	HH B OW
(HE	HH IY
(I	AY
(IE.	AY
(IN	IH N
(IT'S	IH T S
(JON	JH AA N
(KURT	K AH R T
(LARA	L AE R AH
(LITERALLY)	L IH T AH R AH L IY
(MARC	M AA R K
(MARRIAGE	M AE R IH JH
(MORAYS	M AH R EY Z
(MY	M AY
(NED	N EH D
(NICOLAS	N IH K AH L AH Z
(OBVIOUSLY	AA B V IY AH S L IY
(OF	AH V
(ONE	W AH N
(ONMYOJI)	AA N M AY AH JH IY
(OR	AO R
(PERHAPS	P ER HH AE P S
(PLAYED	P L EY D
(PLEASANTVILLE'S	P L IY S AH N T V IH L AH Z
(PRESUMABLY)	P R IH Z UW M AH B L IY
(RADHA	R AE D HH AH
(READ:	R IY D
(RITA	R IH T AH
(ROBIN	R AA B AH N
(RONNY	R AA N IY
(SEXY!)	S EH K S IY
(SUCH	S AH CH
(SUPPOSEDLY	S AH P OW Z AH D L IY
(THE	DH AH
(THERE	DH EH R
(TO	T UW
(TWO	T UW
(WARNING!)	W AO R N IH NG
(WE	W IY
(WHEN	W EH N
(WHICH	W IH CH
(WHO	HH UW
(WHOSE	HH UW Z
(WITH	W IH TH
+/-	
,	
-	
--	
-IN	
.	
...	
....	
....AND	AE N D
007	Z IY R OW Z IY R OW S EH V AH N
0079,	Z IY R OW Z IY R OW S EH V AH N AY N
0080	Z IY R OW Z IY R OW EY T Z IY R OW
0080,	Z IY R OW Z IY R OW EY T Z IY R OW
0083	Z IY R OW Z IY R OW EY T TH R IY
1	W AH N
10	W AH N Z IY R OW
10.	W AH N Z IY R OW
10/10	W AH N Z IY R OW W AH N Z IY R OW
12	W AH N T UW
12:01.	W AH N T UW Z IY R OW W AH N
13	W AH N TH R IY
146	W AH N F OW R S IH K S
17TH	W AH N S EH V AH N T IY EY CH
19	W AH N AY N
1911	W AH N AY N W AH N W AH N
1918.	W AH N AY N W AH N EY T
1920!!	W AH N AY N T UW Z IY R OW
1933"",	W AH N AY N TH R IY TH R IY
1960S	W AH N AY N S IH K S Z IY R OW EH S
1968	W AH N AY N S IH K S EY T
1970S.A	W AH N AY N S EH V AH N Z IY R OW EH S EY
1971.",10,POS	W AH N AY N S EH V AH N W AH N W AH N Z IY R OW P IY OW EH S
1972,	W AH N AY N S EH V AH N T UW
1979,	W AH N AY N S EH V AH N AY N
1980	W AH N AY N EY T Z IY R OW
1980S	W AH N AY N EY T Z IY R OW EH S
1994	W AH N AY N AY N F OW R
1997'S	W AH N AY N AY N S EH V AH N L EH T AH R EH S
2	T UW
20	T UW Z IY R OW
2000'S	T UW Z IY R OW Z IY R OW Z IY R OW L EH T AH R EH S
2001:	T UW Z IY R OW Z IY R OW W AH N
2005	T UW Z IY R OW Z IY R OW F AY V
2007	T UW Z IY R OW Z IY R OW S EH V AH N
24	T UW F OW R
2ND	T UW EH N D IY
3	TH R IY
3""	TH R IY
30	TH R IY Z IY R OW
30'S	TH R IY Z IY R OW L EH T AH R EH S
4	F OW R
4.4	F OW R F OW R
40'S	F OW R Z IY R OW L EH T AH R EH S
40'S),	F OW R Z IY R OW L EH T AH R EH S
5	F AY V
50'S	F AY V Z IY R OW L EH T AH R EH S
50'S.	F AY V Z IY R OW L EH T AH R EH S
6	S IH K S
60'S	S IH K S Z IY R OW L EH T AH R EH S
7	S EH V AH N
7.",7,POS	S EH V AH N S EH V AH N P IY OW EH S
70'S	S EH V AH N Z IY R OW L EH T AH R EH S
70S	S EH V AH N Z IY R OW EH S
70S.	S EH V AH N Z IY R OW EH S
80'S	EY T Z IY R OW L EH T AH R EH S
80'S/EARLY	EY T Z IY R OW L EH T AH R EH S IY EY AA R EH L W AY
80S	EY T Z IY R OW EH S
80S'	EY T Z IY R OW EH S L EH T AH R
9	N AY N
9/10	N AY N W AH N Z IY R OW
9/10!",9,POS	N AY N W AH N Z IY R OW N AY N P IY OW EH S
90	N AY N Z IY R OW
90'S	N AY N Z IY R OW L EH T AH R EH S
90210!	N AY N Z IY R OW T UW W AH N Z IY R OW
:""NO	N OW
:)	
:)",9,POS	N AY N P IY OW EH S
:))	
A	AH
A(2)	EY
A-",7,POS	EY S EH V AH N P IY OW EH S
A-RELIGIOUS	EY R IH L IH JH AH S
ABANDONED	AH B AE N D AH N D
ABASHIDZE....	AE B AH SH AH D Z
ABC	AE B K
ABDUCTION.""MAN	AH B D AH K SH AH N M AE N
ABILITY,	AH B IH L AH T IY
ABLE	EY B AH L
ABOUT	AH B AW T
ABOUT.	AH B AW T
ABSENT.MY	AE B S AH N T M AY
ABSOLUTE	AE B S AH L UW T
ABSOLUTELY	AE B S AH L UW T L IY
ABSURDLY	AH B S ER D L IY
ABYSS	AH B IH S
ACADEMY	AH K AE D AH M IY
ACCENT	AH K S EH N T
ACCENT(2)	AE K S EH N T
ACCENT,	AE K S EH N T
ACCENTUATE	AE K S EH N CH UW EY T
ACCEPTANCE.	AE K S EH P T AH N S
ACCIDENT.	AE K S AH D AH N T
ACCIDENTAL	AE K S AH D EH N T AH L
ACCIDENTAL(2)	AE K S AH D EH N AH L
ACCIDENTALLY	AE K S AH D EH N T AH L IY
ACCIDENTALLY(2)	AE K S AH D EH N AH L IY
ACCOMPANIES	AH K AH M P AH N IY Z
ACCUSATION.	AE K Y AH Z EY SH AH N
ACCUSTOMED	AH K AH S T AH M D
ACHIEVE	AH CH IY V
ACHIEVEMENTS.BUT	AH CH IY V M AH N T S B AH T
ACT	AE K T
ACTED	AE K T IH D
ACTED.	AE K T IH D
ACTING	AE K T IH NG
ACTING.	AE K T IH NG
ACTION	AE K SH AH N
ACTION,	AE K SH AH N
ACTION.	AE K SH AH N
ACTION.MOBILE	AE K SH AH N M OW B AH L
ACTIVISTS	AE K T IH V IH S T S
ACTOR	AE K T ER
ACTOR.	AE K T ER
ACTORS	AE K T ER Z
ACTORS/ACTRESS	AE K T ER Z AE K T R AH S
ACTRESS	AE K T R AH S
ACTRESS.NO	AE K T R AH S N OW
ACTRESSES,	AE K T R AH S IH Z
ACTS	AE K T S
ACTS(2)	AE K S
ACTUAL	AE K CH AH W AH L
ACTUAL(2)	AE K SH AH L
ACTUALLY	AE K CH UW AH L IY
ACTUALLY(2)	AE K CH L IY
ACTUALLY(3)	AE K SH AH L IY
ACTUALLY,	AE K CH AH W AH L IY
ADAPTATION	AE D AH P T EY SH AH N
ADAPTATION,	AE D AE P T EY SH AH N
ADAPTING	AH D AE P T IH NG
ADAPTS	AH D AE P T S
ADD	AE D
ADDED	AE D IH D
ADDITION	AH D IH SH AH N
ADDITIONS:	AH D IH SH AH N Z
ADDRESS,	AH D R EH S
ADJACENT	AH JH EY S AH N T
ADMINISTRATION.	AH D M IH N AH S T R EY SH AH N
ADMIRE	AE D M AY R
ADMIT	AH D M IH T
ADMITS	AH D M IH T S
ADRIAN	EY D R IY AH N
ADULT	AH D AH L T
ADULT(2)	AE D AH L T
ADULT.	AH D AH L T
ADULTS.	AH D AH L T S
ADVENTURE	AE D V EH N CH ER
ADVENTURE(2)	AH D V EH N CH ER
ADVENTURE,	AH D V EH N CH ER
ADVERSARY	AE D V ER S EH R IY
ADVICE	AE D V AY S
ADVICE(2)	AH D V AY S
ADVICES	AH D V AY S IH Z
ADVISED	AE D V AY Z D
ADVISED(2)	AH D V AY Z D
AESTHETIC	EH S TH EH T IH K
AFFAIR	AH F EH R
AFFAIR.STEVEN	AH F EH R S T IY V AH N
AFFECT	AH F EH K T
AFFECTING	AH F EH K T IH NG
AFFECTION	AH F EH K SH AH N
AFFLUENT	AE F L UW AH N T
AFFORD	AH F AO R D
AFRICA.	AE F R IH K AH
AFTER	AE F T ER
AFTER,	AE F T ER
AFTERNOON	AE F T ER N UW N
AFTERNOON.	AE F T ER N UW N
AGAIN	AH G EH N
AGAIN(2)	AH G EY N
AGAIN,	AH G EH N
AGAIN.",8,POS	EY JH IY EY AY EH N EY T P IY OW EH S
AGAIN...	AH G EH N
AGAIN.SISSY	AH G EH N S IY Z IY
AGAINST	AH G EH N S T
AGAINST(2)	AH G EY N S T
AGE	EY JH
AGE,	EY JH
AGED	EY JH D
AGED(2)	EY JH IH D
AGENCY	EY JH AH N S IY
AGENT	EY JH AH N T
AGENTS	EY JH AH N T S
AGES	EY JH IH Z
AGES.	EY JH IH Z
AGING	EY JH IH NG
AGO	AH G OW
AGO,	AH G OW
AGO.	AH G OW
AGO.""SO	AH G OW S OW
AGREE	AH G R IY
AGREED	AH G R IY D
AGREES	AH G R IY Z
AHEAD	AH HH EH D
AIMLESS	EY M L AH S
AIR	EH R
AIR.	EH R
AIRED	EH R D
AIRMEN.	AH IH R M EH N
AL	AE L
AL,	AE L
ALAN	AE L AH N
ALARM	AH L AA R M
ALAS	AH L AE S
ALCOHOLIC	AE L K AH HH AA L IH K
ALEXANDER	AE L IH G Z AE N D ER
ALICE,	AH L AY S
ALIKE	AH L AY K
ALIKE)	AH L AY K
ALIKE.	AH L AY K
ALIKE.DREW	AH L AY K D R UW
ALL	AO L
ALL!	AO L
ALL,	AO L
ALL.	AO L
ALLEGEDLY	AH L EH JH AH D L IY
ALLEN	AE L AH N
ALLEN'S	AE L AH N Z
ALLOW	AH L AW
ALLOWS	AH L AW Z
ALMOST	AO L M OW S T
ALMOST.THE	AO L M OW S T DH AH
ALOHA!",10,POS	EY EH L OW EY CH EY W AH N Z IY R OW P IY OW EH S
ALONE	AH L OW N
ALONE,	AH L OW N
ALONG	AH L AO NG
ALONGNO?	AH L AA N G N OW
ALREADY	AO L R EH D IY
ALREADY(2)	AO R EH D IY
ALRIGHT	AO L R AY T
ALRIGHT'	AO L R AY T
ALSO	AO L S OW
ALSO,	AO L S OW
ALSO.	AO L S OW
ALTERNATE	AO L T ER N AH T
ALTERNATE(2)	AO L T ER N EY T
ALTERNATIVES,	AO L T ER N AH T IH V Z
ALTHOUGH	AO L DH OW
ALWAYS	AO L W EY Z
ALWAYS(2)	AO L W IY Z
ALWAYS,	AO L W EY Z
ALZHEIMER'S	AE L Z HH AY M ER Z
ALZHEIMER'S(2)	AA T S Z HH AY M ER Z
AM	AE M
AM(2)	EY EH M
AMAZED...""BEFORE	AH M EY Z D B IH F OW R
AMAZING	AH M EY Z IH NG
AMAZING.	AH M EY Z IH NG
AMAZING...	AH M EY Z IH NG
AMAZINGLY	AH M EY Z IH NG L IY
AMERICA,	AH M EH R AH K AH
AMERICA.	AH M EH R AH K AH
AMERICAN	AH M EH R IH K AH N
AMERICANS	AH M EH R IH K AH N Z
AMIABLE,	EY M IY AH B AH L
AMONG	AH M AH NG
AMORAL,	EY M AO R AH L
AMOUNT	AH M AW N T
AMROHI	AE M R AH HH IY
AMURO	AE M Y AH R OW
AMUSING	AH M Y UW Z IH NG
AN	AE N
AN(2)	AH N
ANCIENT	EY N CH AH N T
ANCIENT(2)	EY N SH AH N T
AND	AH N D
AND(2)	AE N D
AND,	AE N D
AND/OR	AE N D AO R
ANDERS	AE N D ER Z
ANDERS'	AE N D ER Z
ANDERS)	AE N D AH R Z
ANDERS.	AE N D AH R Z
ANGELA	AE N JH AH L AH
ANGLES	AE NG G AH L Z
ANGUISH	AE NG G W IH SH
ANIMALS	AE N AH M AH L Z
ANIMALS,	AE N AH M AH L Z
ANIMALS.'	AE N AH M AH L Z
ANIMATED	AE N AH M EY T IH D
ANIMATION	AE N AH M EY SH AH N
ANIMATRONIC	AE N AH M AE T R AH N AH K
ANNALS	AE N AH L Z
ANNOYING	AH N OY IH NG
ANOTHER	AH N AH DH ER
ANSWER,	AE N S ER
ANSWERS.	AE N S ER Z
ANTHONY),	AE N T HH OW N IY
ANTICIPATES,	AE N T IH S AH P AH T S
ANTICIPATION.	AE N T IH S AH P EY SH AH N
ANXIOUS	AE NG K SH AH S
ANXIOUS(2)	AE NG SH AH S
ANY	EH N IY
ANYHOW,	EH N IY HH AW
ANYMORE.	EH N IY M OW R
ANYONE	EH N IY W AH N
ANYONE'S	EH N IY W AH N Z
ANYTHING	EH N IY TH IH NG
ANYWAY,	EH N IY W EY
ANYWHERE	EH N IY W EH R
ANYWHERE(2)	EH N IY HH W EH R
APART	AH P AA R T
APARTMENT	AH P AA R T M AH N T
APEL	AA P EH L
APPARENT	AH P EH R AH N T
APPARENTLY	AH P EH R AH N T L IY
APPEAL	AH P IY L
APPEALING	AH P IY L IH NG
APPEAR	AH P IH R
APPEARANCE.FAVORITE	AH P IH ER AH N S F EY V AH R AH T
APPEARED	AH P IH R D
APPLAUDED	AH P L AO D IH D
APPLICATION	AE P L AH K EY SH AH N
APPRECIATE	AH P R IY SH IY EY T
APPRECIATED	AH P R IY SH IY EY T IH D
APPRECIATION	AH P R IY SH IY EY SH AH N
APPROACH	AH P R OW CH
APPROPRIATE	AH P R OW P R IY AH T
APPROPRIATE(2)	AH P R OW P R IY EY T
APPROVAL	AH P R UW V AH L
APRIL	EY P R AH L
ARE	AA R
ARE(2)	ER
ARE,	AA R
AREA	EH R IY AH
AREAS	EH R IY AH Z
AREN'T	AA R AH N T
AREN'T(2)	AA R N T
ARETHA	ER IY TH AH
ARMY	AA R M IY
ARMY,	AA R M IY
AROUND	ER AW N D
AROUND(2)	ER AW N
AROUND,	AH R AW N D
AROUND.	AH R AW N D
ARRIVAL,	AH R AY V AH L
ARRIVES	ER AY V Z
ART	AA R T
ART.	AA R T
ART.",10,POS	EY AA R T IY W AH N Z IY R OW P IY OW EH S
ARTICULATE	AA R T IH K Y AH L EY T
ARTICULATE(2)	AA R T IH K Y AH L AH T
ARTIFICIAL	AA R T AH F IH SH AH L
ARTIFICIALLY	AA R T AH F IH SH AH L IY
ARTIST	AA R T AH S T
ARTIST(2)	AA R T IH S T
ARTISTIC	AA R T IH S T IH K
ARTISTS,	AA R T IH S T S
ARTS	AA R T S
AS	AE Z
AS(2)	EH Z
AS,	AE Z
ASHURA	AE SH AH R AH
ASHURA,	AE SH AH R AH
ASHURA.	AE SH AH R AH
ASIAN	EY ZH AH N
ASIDE	AH S AY D
ASKED	AE S K T
ASKED(2)	AE S T
ASPECTS	AE S P EH K T S
ASS?	AE S
ASSASSIN	AH S AE S AH N
ASSAULT	AH S AO L T
ASSHOLE...SEEMS	AE S HH OW L S IY M Z
ASSUMED	AH S UW M D
ASTAIRE	AH S T EH R
ASTAIRE/ROGERS	AE S T AH AH R AA JH ER Z
ASTRONOMICAL	AE S T R AH N AA M IH K AH L
AT	AE T
AT:	AE T
ATHINODOROS	AH TH IH N OW D ER AA S
ATLANTA	AE T L AE N T AH
ATMOSPHERE	AE T M AH S F IH R
ATMOSPHERE...	AE T M AH S F IH ER
ATMOSPHERIC	AE T M AH S F EH R IH K
ATMOSPHERIC,	AE T M AH S F IH ER IH K
ATTACK	AH T AE K
ATTACK-	AH T AE K
ATTACKING	AH T AE K IH NG
ATTEMPT	AH T EH M P T
ATTEMPTS	AH T EH M P T S
ATTEND	AH T EH N D
ATTENTION	AH T EH N SH AH N
ATTENTION!",10,POS	EY T IY T IY IY EH N T IY AY OW EH N W AH N Z IY R OW P IY OW EH S
ATTRACTIVE,	AH T R AE K T IH V
ATTRACTIVE.	AH T R AE K T IH V
AUDIENCE	AA D IY AH N S
AUDIENCE(2)	AO D IY AH N S
AUDIENCE'S	AA D IY AH N S AH Z
AUDIENCE'S(2)	AO D IY AH N S AH Z
AUDIENCE.	AO D IY AH N S
AUDIENCE.THAT'S	AO D IY AH N S DH AE T S
AUDIENCES	AA D IY AH N S AH Z
AUDIENCES(2)	AO D IY AH N S AH Z
AUNT'S	AE N T S
AUNT'S(2)	AO N T S
AUR	AO R
AUSTRALIA	AO S T R EY L Y AH
AUSTRALIAN	AO S T R EY L Y AH N
AUTHENTIC	AH TH EH N T IH K
AUTHENTIC(2)	AO TH EH N T IH K
AUTHENTIC(3)	AO TH EH N IH K
AUTHENTIC(4)	AH TH EH N IH K
AUTHORITY	AH TH AO R AH T IY
AUTISM	AO T IH Z AH M
AVATAR	AE V AH T AA R
AVERAGE	AE V ER IH JH
AVERAGE(2)	AE V R IH JH
AVERAGE.	AE V R IH JH
AVIATION	EY V IY EY SH AH N
AVOIDS	AH V OY D Z
AWARD	AH W AO R D
AWAY	AH W EY
AWAY---I	AH W EY
AWAY.",9,POS	EY D AH B AH L Y UW EY W AY N AY N P IY OW EH S
AWESOME!	AO S AH M
AWESOME,	AO S AH M
AWHILE,	AH W AY L
AWKWARD	AA K W ER D
AWKWARD(2)	AO K W ER D
BABBS	B AE B Z
BABY	B EY B IY
BACHELOR	B AE CH AH L ER
BACHELOR(2)	B AE CH L ER
BACK	B AE K
BACK!",9,POS	B IY EY S IY K EY N AY N P IY OW EH S
BACK'	B AE K
BACKGROUND	B AE K G R AW N D
BACON,	B EY K AH N
BAD	B AE D
BAD...FOR	B AE D F AO R
BAHRAIN.	B AH R EY N
BAKERSFIELD	B EY K ER Z F IY L D
BALANCE	B AE L AH N S
BALANCE,	B AE L AH N S
BALL.	B AO L
BALLET	B AE L EY
BALLING	B AO L IH NG
BAMBINO'.EVERYTHING	B AE M B AH N AH EH V R IY TH IH NG
BANDS	B AE N D Z
BANG	B AE NG
BANTERING	B AE N T ER IH NG
BAR	B AA R
BARBARA	B AA R B ER AH
BARBARA(2)	B AA R B R AH
BARELY	B EH R L IY
BARR	B AA R
BARRYMORE	B AE R IY M AO R
BARRYMORE(2)	B EH R IY M AO R
BARTY.	B AA R T IY
BASEBALL	B EY S B AO L
BASED	B EY S T
BASEMENT	B EY S M AH N T
BASEMENT.	B EY S M AH N T
BASHING	B AE SH IH NG
BASICALLY	B EY S IH K L IY
BASKET""	B AE S K AH T
BAT	B AE T
BATHROOM	B AE TH R UW M
BATTLE	B AE T AH L
BATTLE.	B AE T AH L
BAUREL,	B AO R AH L
BAVA	B AA V AH
BAWDY,	B AO D IY
BE	B IY
BE)	B IY
BE,	B IY
BE.	B IY
BE?'	B IY
BE?'---THIS	B IY
BEAMED	B IY M D
BEAST.	B IY S T
BEAST?",10,POS	B IY IY EY EH S T IY W AH N Z IY R OW P IY OW EH S
BEATTY);	B IY T IY
BEAUTIFUL	B Y UW T AH F AH L
BEAUTIFUL.",10,POS	B IY IY EY Y UW T IY AY EH F Y UW EH L W AH N Z IY R OW P IY OW EH S
BEAUTIFULLY	B Y UW T AH F L IY
BEAUTIFULLY-FILMED	B Y UW T AH F L IY F IH L M D
BEAUTY	B Y UW T IY
BEAUTY.	B Y UW T IY
BEAUTY.",10,POS	B IY IY EY Y UW T IY W AY W AH N Z IY R OW P IY OW EH S
BECAME	B IH K EY M
BECAME(2)	B IY K EY M
BECAME.	B IH K EY M
BECAUSE	B IH K AO Z
BECAUSE(2)	B IH K AH Z
BECAUSE(3)	B IH K AA Z
BECAUSE,	B IH K AO Z
BECKINSALE'S	B EH K IH N S EY L Z
BECKY	B EH K IY
BECOME	B IH K AH M
BECOMES	B IH K AH M Z
BECOMING	B IH K AH M IH NG
BEDROOM	B EH D R UW M
BEECH(NICK	B IY CH N IH K
BEEN	B IH N
BEEN(2)	B AH N
BEEN.",9,POS	B IY IY IY EH N AY N P IY OW EH S
BEFORE	B IH F AO R
BEFORE(2)	B IY F AO R
BEFORE,	B IH F OW R
BEFORE.	B IH F OW R
BEFORE:	B IH F OW R
BEFORE?	B IH F OW R
BEFRIENDS	B IH F R EH N D Z
BEGAN	B IH G AE N
BEGAN(2)	B IY G AE N
BEGIN	B IH G IH N
BEGIN?MEENA	B IH G IH N M IY N AH
BEGINNING	B IH G IH N IH NG
BEGINNING,	B IH G IH N IH NG
BEGINS	B IH G IH N Z
BEGINS.	B IH G IH N Z
BEHAVIOR	B IH HH EY V Y ER
BEHIND	B IH HH AY N D
BEHIND,'	B IH HH AY N D
BEING	B IY IH NG
BEING.",7,POS	B IY IY AY EH N JH IY S EH V AH N P IY OW EH S
BEINGS	B IY IH NG Z
BELIEFS	B IH L IY F S
BELIEVABLE	B AH L IY V AH B AH L
BELIEVE	B IH L IY V
BELIEVE,LED	B AH L IY V L EH D
BELIEVED	B IH L IY V D
BELUSHI	B EH L UW SH IY
BELUSHI,	B AH L AH SH IY
BEN	B EH N
BENARD	B IH N AA R D
BENDING	B EH N D IH NG
BENEATH	B IH N IY TH
BENEFIT	B EH N AH F IH T
BERLIN'S	B ER L IH N Z
BERNIE	B ER N IY
BERRY	B EH R IY
BERSERK	B ER S ER K
BEST	B EH S T
BEST,	B EH S T
BEST.	B EH S T
BEST......	B EH S T
BETTER	B EH T ER
BETTER,	B EH T ER
BETWEEN	B IH T W IY N
BETWEEN(2)	B IY T W IY N
BEYOND	B IH AA N D
BEYOND(2)	B IY AO N D
BEYOND(3)	B IH AO N D
BI	B AY
BIASED	B AY AH S T
BIBI	B IH B IY
BIBI(2)	B IY B IY
BIG	B IH G
BIG,	B IH G
BIG.	B IH G
BIGGER	B IH G ER
BIGGER-THAN-LIFE	B IH G ER DH AE N L AY F
BIGGEST	B IH G AH S T
BILL	B IH L
BILL.",8,POS	B IY AY EH L EH L EY T P IY OW EH S
BILLY	B IH L IY
BINDER.	B AY N D ER
BINDING	B AY N D IH NG
BIRTH,	B ER TH
BIRTHDAY	B ER TH D EY
BIT	B IH T
BIT,	B IH T
BIT.	B IH T
BITCHY	B IH CH IY
BIZARRE	B AH Z AA R
BIZARRE(2)	B IH Z AA R
BIZARRE,	B AH Z AA R
BLACK	B L AE K
BLACK""	B L AE K
BLAME	B L EY M
BLAMES	B L EY M Z
BLEW	B L UW
BLOOD	B L AH D
BLOOD""),	B L AH D
BLOODLUST	B L AH D L AH S T
BLOODY	B L AH D IY
BLOW-HARD	B L OW HH AA R D
BLOWING	B L OW IH NG
BLOWN	B L OW N
BLUE	B L UW
BOASTS	B OW S T S
BOAT	B OW T
BOB	B AA B
BOBBY,	B AA B IY
BODIES	B AA D IY Z
BODYGUARD	B AA D IY G AA R D
BODYGUARD,	B AA D IY G AA R D
BOGOSIAN	B AH G AA ZH IH N
BOLLYWOOD	B AO L IH W UH D
BOMBASTIC	B AA M B AE S T IH K
BOMBED	B AA M D
BOND)	B AA N D
BONES	B OW N Z
BOOGIE	B UW G IY
BOOGIE(2)	B UH G IY
BOOK	B UH K
BOOK,	B UH K
BOOKS	B UH K S
BOORMAN'S	B UH R M AH N Z
BORDER	B AO R D ER
BORE,	B AO R
BORING.	B AO R IH NG
BORING?	B AO R IH NG
BORNE	B AO R N
BOSWELL	B AA Z W EH L
BOTH	B OW TH
BOTH,	B OW TH
BOTHERS	B AA DH ER Z
BOTTLE	B AA T AH L
BOTTOM	B AA T AH M
BOTTOMS	B AA T AH M Z
BOUGHT	B AA T
BOUGHT(2)	B AO T
BOULEVARDIER	B UH L AH V AA R D IY ER
BOUND	B AW N D
BOWELS.	B AW AH L Z
BOX.	B AA K S
BOY	B OY
BOYLE).	B OY L
BOYLE,	B OY L
BOYS	B OY Z
BOYS.THE	B OY Z DH AH
BOYS/BABIES/MICE	B OY Z B EY B IY Z M AY S
BRAINY,	B R EY N IY
BRANAGH	B R AE N AH G
BRANDO	B R AE N D OW
BRAT.	B R AE T
BREAK	B R EY K
BREAK--MR.	B R EY K
BREAKDOWN.	B R EY K D AW N
BREAKS	B R EY K S
BREATH	B R EH TH
BREATHING	B R IY DH IH NG
BREATHLESS.NAUSHADS	B R EH TH L AH S N AO SH AH D Z
BRIBES	B R AY B Z
BRIDGE	B R IH JH
BRIGHT,	B R AY T
BRILLANT	B R IH L AH N T
BRILLIANCE	B R IH L Y AH N S
BRILLIANT	B R IH L Y AH N T
BRILLIANT.	B R IH L Y AH N T
BRILLIANTLY	B R IH L Y AH N T L IY
BRING	B R IH NG
BRINGS	B R IH NG Z
BRITISH	B R IH T IH SH
BROADWAY	B R AO D W EY
BROKEN	B R OW K AH N
BROKERS	B R OW K ER Z
BRONSTEIN.	B R AA N S T IY N
BROTHER	B R AH DH ER
BROTHERS	B R AH DH ER Z
BROUGHT	B R AO T
BROWN	B R AW N
BROWN""	B R AW N
BROWN,	B R AW N
BROWN.	B R AW N
BRUTAL	B R UW T AH L
BRUTALLY	B R UW T AH L IY
BUCKETS	B AH K AH T S
BUCKS	B AH K S
BUDDIES	B AH D IY Z
BUDDY	B AH D IY
BUDGET	B AH JH IH T
BUDGET.	B AH JH AH T
BUILDING).	B IH L D IH NG
BUILDINGS,	B IH L D IH NG Z
BUILDINGS.	B IH L D IH NG Z
BUILT	B IH L T
BULK	B AH L K
BUNCH	B AH N CH
BURIED	B EH R IY D
BURROWS	B ER OW Z
BUSHMAN.	B UH SH M AE N
BUSINESS	B IH Z N AH S
BUSINESS(2)	B IH Z N IH S
BUSY	B IH Z IY
BUT	B AH T
BUT,	B AH T
BUT.	B AH T
BUY	B AY
BUYS	B AY Z
BY	B AY
BYRDS.	B AH R D Z
BYRON	B AY R AH N
C	S IY
C'EST	S EH S T
C'EST(2)	S EY
CABAL'	K AH B AA L
CABAL'S	K AH B AA L Z
CABAL'S'	K AE B AH L Z
CADET,	K AH D EH T
CAGE)	K EY JH
CAGNEY	K AE G N IY
CAHULAWASSEE	K AE HH Y UW L AH AH S IY IY
CALAMITIES	K AH L AE M AH T IY Z
CALCULATING,	K AE L K Y AH L EY T IH NG
CALENDER	K AH L EH N D AH R
CALL	K AO L
CALLED	K AO L D
CAME	K EY M
CAMEO	K AE M IY OW
CAMERA	K AE M ER AH
CAMERA(2)	K AE M R AH
CAMERA.	K AE M R AH
CAMP	K AE M P
CAMPY	K AE M P IY
CAN	K AE N
CAN(2)	K AH N
CAN'T	K AE N T
CANADIAN	K AH N EY D IY AH N
CANDIDATES	K AE N D AH D EY T S
CANDIDATES(2)	K AE N AH D IH T S
CANDY'S	K AE N D IY Z
CANNOT	K AE N AA T
CANNOT(2)	K AH N AA T
CANVAS	K AE N V AH S
CAPITALIZES	K AE P AH T AH L AY Z IH Z
CAPSULE	K AE P S AH L
CAPTORS	K AE P T ER Z
CAPTURE	K AE P CH ER
CAPTURED	K AE P CH ER D
CAPTURES	K AE P CH ER Z
CAR	K AA R
CARA.	K AE R AH
CARE	K EH R
CAREER	K ER IH R
CAREER,	K AH R IH ER
CAREER.	K AH R IH ER
CAREFUL	K EH R F AH L
CAREFULLY	K EH R F AH L IY
CARES	K EH R Z
CAREY.THERE	K EH R IY DH EH R
CARHART	K AA R HH AA R T
CARNIVAL	K AA R N AH V AH L
CARON	K AA R AO N
CARRIES	K AE R IY Z
CARRIES(2)	K EH R IY Z
CARRYING	K AE R IY IH NG
CARRYING(2)	K EH R IY IH NG
CARS,	K AA R Z
CASA	K AA S AH
CASE	K EY S
CASE,	K EY S
CAST	K AE S T
CAST,	K AE S T
CAST.	K AE S T
CASTING	K AE S T IH NG
CASTLE	K AE S AH L
CASTLE,	K AE S AH L
CATALOG	K AE T AH L AO G
CATCH	K AE CH
CATCHY	K AE CH IY
CAUGHT	K AA T
CAUGHT(2)	K AO T
CAUGHT,	K AO T
CAUSE	K AA Z
CAUSE(2)	K AO Z
CAUSE,	K AO Z
CAUSED	K AA Z D
CAUSED(2)	K AO Z D
CB4	S IY B IY F OW R
CEDRIC'S,	S EH D R AH S Z
CELEBRATED	S EH L AH B R EY T IH D
CEMETERY""	S EH M AH T EH R IY
CEMETERY"".	S EH M AH T EH R IY
CENTER	S EH N T ER
CENTER(2)	S EH N ER
CENTRAL	S EH N T R AH L
CENTS.",10,POS	S IY IY EH N T IY EH S W AH N Z IY R OW P IY OW EH S
CENTURY	S EH N CH ER IY
CEREBRAL	S EH R AH B R AH L
CEREBRAL(2)	S ER IY B R AH L
CERTAIN	S ER T AH N
CERTAINLY	S ER T AH N L IY
CG	S IY G
CHAIRS	CH EH R Z
CHALK	CH AA K
CHALK(2)	CH AO K
CHALLENGING	CH AE L AH N JH IH NG
CHANCE	CH AE N S
CHANCE,	CH AE N S
CHANCE.	CH AE N S
CHANCE.",9,POS	S IY EY CH EY EH N S IY IY N AY N P IY OW EH S
CHANGE	CH EY N JH
CHANGED""	CH EY N JH D
CHANGED.	CH EY N JH D
CHANGES	CH EY N JH AH Z
CHANGES(2)	CH EY N JH IH Z
CHANGING	CH EY N JH IH NG
CHANNEL	CH AE N AH L
CHARACTER	K EH R IH K T ER
CHARACTER,	K AE R IH K T ER
CHARACTER.	K AE R IH K T ER
CHARACTERISATIONS	K AE R IH K T ER IY Z EY SH AH N Z
CHARACTERIZATION.	K AE R IH K T ER AH Z EY SH AH N
CHARACTERIZE	K EH R IH K T ER AY Z
CHARACTERIZED	K EH R IH K T ER AY Z D
CHARACTERS	K AE R IH K T ER Z
CHARACTERS(2)	K EH R IH K T ER Z
CHARACTERS-	K AE R IH K T ER Z
CHARACTERS.	K AE R IH K T ER Z
CHARACTERS:	K AE R IH K T ER Z
CHAREL	CH AE R AH L
CHAREL'S	CH AE R AH L Z
CHAREL,	CH AE R AH L
CHARGED	CH AA R JH D
CHARITY	CH EH R IH T IY
CHARLES	CH AA R L Z
CHARLES(2)	CH AA R AH L Z
CHARM	CH AA R M
CHARM.	CH AA R M
CHARTS	CH AA R T S
CHASE.",9,POS	S IY EY CH EY EH S IY N AY N P IY OW EH S
CHASES	CH EY S AH Z
CHASES(2)	CH EY S IH Z
CHAVALIER,	CH AH V AE L AY AH R
CHAVEZ	SH AA V EH Z
CHAVEZ(2)	CH AE V EH Z
CHAVEZ(3)	SH AH V EH Z
CHAVEZ.	CH AE V AH Z
CHEADLE	CH IY D AH L
CHEAP	CH IY P
CHECK	CH EH K
CHECKED	CH EH K T
CHEER-UP	CH IH R AH P
CHEESE	CH IY Z
CHEESECAKE	CH IY Z K EY K
CHEESINESS	CH IY Z IY N AH S
CHEEZY	CH IY Z IY
CHEEZY.	CH IY Z IY
CHEMISTRY	K EH M IH S T R IY
CHIAURELI,VERIKOAN	CH AY AH UH R AH L IY V AH R IH K OW AH N
CHILD	CH AY L D
CHILD'S	CH AY L D Z
CHILD--I	CH AY L D
CHILDHOOD	CH AY L D HH UH D
CHILDLIKE	CH AY L D L AY K
CHILDREN	CH IH L D R AH N
CHILDREN.	CH IH L D R AH N
CHILDREN.",7,POS	S IY EY CH AY EH L D IY AA R IY EH N S EH V AH N P IY OW EH S
CHILLS	CH IH L Z
CHINESE	CH AY N IY Z
CHOCOLATE	CH AO K L AH T
CHOICE.	CH OY S
CHOOSE	CH UW Z
CHOPPILY	CH AA P IY L IY
CHORUS	K AO R AH S
CHOSEN	CH OW Z AH N
CHOSEN.	CH OW Z AH N
CHRISTINA	K R IH S T IY N AH
CHRISTINE	K R IH S T IY N
CHRISTOPHER	K R IH S T AH F ER
CHUCK	CH AH K
CHUNKS.'	CH AH NG K S
CHURCH""	CH ER CH
CHURCHILL	CH ER CH IH L
CHURCHILL(2)	CH ER CH HH IH L
CIA	S IY AY EY
CIARIN	S AY AH R AH N
CINDERELLA	S IH N D ER EH L AH
CINDERELLA,	S IH N D AH R EH L AH
CINEMA	S IH N AH M AH
CINEMA'S	S IH N AH M AH Z
CINEMA,	S IH N AH M AH
CINEMA.	S IH N AH M AH
CINEMATIC	S IH N AH M AE T IH K
CINEMATOGRAPHY	S IH N IH M AH T AA G R AH F IY
CIRCLE,	S ER K AH L
CITIES	S IH T IY Z
CITIZENS	S IH T AH Z AH N Z
CITIZENS(2)	S IH T IH Z AH N Z
CITY	S IH T IY
CITY,	S IH T IY
CIVILIZED	S IH V AH L AY Z D
CLARKE	K L AA R K
CLASSIC	K L AE S IH K
CLASSIC,	K L AE S IH K
CLASSICS	K L AE S IH K S
CLEANING	K L IY N IH NG
CLEAR	K L IH R
CLEARENCE	K L IH ER AH N S
CLEARLY	K L IH R L IY
CLEVELAND	K L IY V L AH N D
CLEVER	K L EH V ER
CLEVER,	K L EH V ER
CLICHE	K L IY SH EY
CLICHéS	K L IH CH S
CLICHéS,	K L IH CH S
CLICK	K L IH K
CLIMBS	K L AY M Z
CLINT	K L IH N T
CLIPPED	K L IH P T
CLIPS	K L IH P S
CLOSE	K L OW S
CLOSE(2)	K L OW Z
CLOSE.	K L OW Z
CLOSELY	K L OW S L IY
CLOSING	K L OW Z IH NG
CLOSURE.	K L OW ZH ER
CLOUDS	K L AW D Z
CLOWN	K L AW N
CLUB,	K L AH B
CLUBS	K L AH B Z
CODE	K OW D
COLD	K OW L D
COLLEGE	K AA L IH JH
COLLETTE'S	K AH L EH TS
COLLETTE,	K AA L EH T
COLONY	K AA L AH N IY
COLONY,	K AA L AH N IY
COLOURS	K AH L ER Z
COLUMBINE	K AA L AH M B AY N
COLUMN,	K AA L AH M
COMBINATION	K AA M B AH N EY SH AH N
COME	K AH M
COME.	K AH M
COMEBACK	K AH M B AE K
COMEDIC	K AH M IY D IH K
COMEDIES	K AA M AH D IY Z
COMEDY	K AA M AH D IY
COMEDY,	K AA M AH D IY
COMEDY-EXPLOITATION	K AA M AH D IY EH K S P L OY T EY SH AH N
COMEDY.	K AA M AH D IY
COMEDY.WHAT	K AA M AH D IY W AA T
COMES	K AH M Z
COMICAL,	K AA M IH K AH L
COMING	K AH M IH NG
COMMANDING	K AH M AE N D IH NG
COMMENT	K AA M EH N T
COMMENTATOR	K AA M AH N T EY T ER
COMMENTED	K AA M EH N T AH D
COMMENTING	K AA M EH N T IH NG
COMMIT	K AH M IH T
COMMON	K AA M AH N
COMPANY.BRING	K AH M P AH N IY B R IH NG
COMPARED	K AH M P EH R D
COMPELLING	K AH M P EH L IH NG
COMPETENT	K AA M P AH T IH N T
COMPILATION	K AA M P AH L EY SH AH N
COMPLAINT	K AH M P L EY N T
COMPLETE	K AH M P L IY T
COMPLETELY	K AH M P L IY T L IY
COMPLEX	K AA M P L EH K S
COMPLEX(2)	K AH M P L EH K S
COMPLICATED	K AA M P L AH K EY T AH D
COMPLICATED.	K AA M P L AH K EY T IH D
COMPLICATION	K AA M P L AH K EY SH AH N
COMPOSED	K AH M P OW Z D
COMPOSER	K AH M P OW Z ER
COMPOSERS,	K AH M P OW Z ER Z
CONCEITED	K AH N S IY T AH D
CONCENTRATED	K AA N S AH N T R EY T AH D
CONCENTRATED(2)	K AO N S AH N T R EY T IH D
CONCENTRATES	K AA N S AH N T R EY T S
CONCERN	K AH N S ER N
CONCERNS	K AH N S ER N Z
CONCLUDED	K AH N K L UW D AH D
CONCLUDED(2)	K AH N K L UW D IH D
CONCLUSION.WHETHER	K AH N K L UW ZH AH N W EH DH ER
CONDENSING	K AH N D EH N S IH NG
CONDITION;	K AH N D IH SH AH N
CONFIDENCE.	K AA N F AH D AH N S
CONFRONT	K AH N F R AH N T
CONFRONTING	K AH N F R AH N T IH NG
CONFUSED	K AH N F Y UW Z D
CONFUSED,	K AH N F Y UW Z D
CONFUSING	K AH N F Y UW Z IH NG
CONJUNCTIVITIS	K AH N JH AH NG K T IH V AH T IY Z
CONNERY	K AA N ER IY
CONSEQUENCE,	K AA N S AH K W AH N S
CONSIDER	K AH N S IH D ER
CONSIDERED	K AH N S IH D ER D
CONSIDERING	K AH N S IH D ER IH NG
CONSIDERS	K AH N S IH D ER Z
CONSISTS	K AH N S IH S T S
CONSTANTLY	K AA N S T AH N T L IY
CONSTRUCTION	K AH N S T R AH K SH AH N
CONTAINS	K AH N T EY N Z
CONTAINS,	K AH N T EY N Z
CONTENT	K AA N T EH N T
CONTENT(2)	K AH N T EH N T
CONTEST	K AA N T EH S T
CONTEST(2)	K AH N T EH S T
CONTEST,	K AH N T EH S T
CONTINUED	K AH N T IH N Y UW D
CONTINUITY,	K AA N T AH N UW AH T IY
CONTINUITY--CINDERELLA	K AA N T AH N UW AH T IY
CONTRARY,	K AA N T R EH R IY
CONTRIBUTIONS	K AA N T R AH B Y UW SH AH N Z
CONTRIVED,	K AH N T R AY V D
CONTROL.	K AH N T R OW L
CONTROVERSY	K AA N T R AH V ER S IY
CONVENTION,	K AA N V AH N CH AH N
CONVENTIONAL	K AH N V EH N SH AH N AH L
CONVEY	K AH N V EY
CONVICTED.	K AA N V IH K T IH D
COOKED	K UH K T
COOKIE	K UH K IY
COOL	K UW L
COOL,	K UW L
COP	K AA P
COPY	K AA P IY
CORE	K AO R
CORMAN	K AO R M AH N
CORMAN-PRODUCED	K AO R M AH N P R AH D UW S T
CORNY	K AO R N IY
CORPORATE	K AO R P ER AH T
CORPORATE(2)	K AO R P R AH T
CORRECT	K ER EH K T
CORRECT,	K AH R EH K T
COST	K AA S T
COST(2)	K AO S T
COSTLY	K AA S T L IY
COSTLY(2)	K AO S T L IY
COSTUMES	K AA S T UW M Z
COSTUMING	K AA S T UW M IH NG
COULD	K UH D
COULD.	K UH D
COUNTEROFFER,	K AW N T ER AO F ER
COUNTING	K AW N T IH NG
COUNTRIES.	K AH N T R IY Z
COUNTRY	K AH N T R IY
COUNTRYSIDE,	K AH N T R IY S AY D
COUPLE	K AH P AH L
COUPLED	K AH P AH L D
COUPS	K UW Z
COUPS.	K UW Z
COURAGEOUS	K ER EY JH AH S
COURSE	K AO R S
COURSE,	K OW R S
COURSE.	K OW R S
COURT	K AO R T
COURTESAN	K OW R T AH S AH N
COURTNEY	K AO R T N IY
COURTROOM	K AO R T R UW M
COVER,	K AH V ER
COWORKER	K OW W ER K ER
COX);	K AA K S
COX.	K AA K S
CRADLE	K R EY D AH L
CRAFTING	K R AE F T IH NG
CRAIG	K R EY G
CRAP	K R AE P
CRAPPY	K R AE P IY
CRASH.	K R AE SH
CRAZED	K R EY Z D
CRAZY	K R EY Z IY
CREAMED	K R IY M D
CREASEY'S	K R IY S IY Z
CREASY	K R IY S IY
CREASY,	K R IY S IY
CREATE	K R IY EY T
CREATED	K R IY EY T AH D
CREATED(2)	K R IY EY T IH D
CREATING	K R IY EY T IH NG
CREATORS	K R IY EY T ER Z
CREATURE	K R IY CH ER
CREDIT	K R EH D AH T
CREDIT(2)	K R EH D IH T
CREEPY	K R IY P IY
CREW	K R UW
CREW!",10,POS	S IY AA R IY D AH B AH L Y UW W AH N Z IY R OW P IY OW EH S
CREW.	K R UW
CRIED	K R AY D
CRIME	K R AY M
CRIMES	K R AY M Z
CRIMES)	K R AY M Z
CRIMINAL	K R IH M AH N AH L
CRIMINALS,	K R IH M AH N AH L Z
CRIPPLED,	K R IH P AH L D
CRISIS	K R AY S AH S
CRISIS,	K R AY S AH S
CRISTY	K R IH S T IY
CRITICISM	K R IH T IH S IH Z AH M
CRITICISMS	K R IH T IH S IH Z AH M Z
CRITICS	K R IH T IH K S
CROWD.	K R AW D
CRUEL	K R UW AH L
CRUEL(2)	K R UW L
CRY	K R AY
CRYING	K R AY IH NG
CRYPTIC	K R IH P T IH K
CUBE),	K Y UW B
CULT	K AH L T
CULTURAL	K AH L CH ER AH L
CULTURE	K AH L CH ER
CULTURE---IN	K AH L CH ER
CUP	K AH P
CURED	K Y UH R D
CURSE	K ER S
CURSE.	K ER S
CURTIS	K ER T AH S
CURTIS(2)	K ER T IH S
CUT	K AH T
CUTESY	K Y UW T S IY
CUTTER	K AH T ER
CUTTING-EDGE	K AH T IH NG EH JH
CYCLOPS	S AY K L AO P S
CYCLOPS,	S IH K L AH P S
DA	D AA
DA(2)	D IY EY
DAISIES	D EY Z IY Z
DAISY	D EY Z IY
DAKOTA	D AH K OW T AH
DALLAS	D AE L AH S
DALTON	D AO L T AH N
DAM	D AE M
DAMN...THE	D AE M DH AH
DAN,	D AE N
DANCE	D AE N S
DANCE""	D AE N S
DANCE.	D AE N S
DANCER,	D AE N S ER
DANCERS	D AE N S ER Z
DANCING	D AE N S IH NG
DANCING.	D AE N S IH NG
DANDY,	D AE N D IY
DANELIA	D AH N IY L Y AH
DANGER	D EY N JH ER
DANGER,	D EY N JH ER
DANGEROUS	D EY N JH ER AH S
DANIEL	D AE N Y AH L
DANTE.	D AE N T
DAOSHVILI	D EY AA SH V AH L IY
DARE	D EH R
DARES	D EH R Z
DARK	D AA R K
DARLENE	D AA R L IY N
DATE	D EY T
DATE.",7,POS	D IY EY T IY IY S EH V AH N P IY OW EH S
DATED	D EY T IH D
DAUGHTER	D AO T ER
DAVID	D EY V IH D
DAVID,	D EY V IH D
DAWN"".	D AO N
DAWN).	D AO N
DAY	D EY
DAY,	D EY
DAY-LEWIS	D EY L UW IH S
DAY-LEWIS,	D EY L UW AH S
DAY.	D EY
DAYS	D EY Z
DAYS,	D EY Z
DAYS.",8,POS	D IY EY W AY EH S EY T P IY OW EH S
DC	D IY S IY
DC-OR	D IY S IY AO R
DEAD.	D EH D
DEAF	D EH F
DEAL	D IY L
DEALER	D IY L ER
DEALERS	D IY L ER Z
DEALING	D IY L IH NG
DEALS	D IY L Z
DEALS.	D IY L Z
DEATH	D EH TH
DEATH,	D EH TH
DEATH.	D EH TH
DEATH.THE	D EH TH DH AH
DECADE.THE	D EH K EY D DH AH
DECADENT	D EH K AH D AH N T
DECADES	D EH K EY D Z
DECEASED	D IH S IY S T
DECEIVE	D IH S IY V
DECEIVED.	D IH S IY V D
DECENCY.	D IY S AH N S IY
DECENT	D IY S AH N T
DECEPTIVE	D IH S EH P T IH V
DECIDE	D IH S AY D
DECIDED	D IH S AY D IH D
DECIDES	D IH S AY D Z
DECK.""	D EH K
DEDICATED	D EH D AH K EY T AH D
DEEP	D IY P
DEEP.WATCH	D IY P W AA CH
DEEPER	D IY P ER
DEFEAT---AUDLEY	D IH F IY T
DEFENDING	D IH F EH N D IH NG
DEFINATELY	D IH F AY N AH T L IY
DEFINED	D IH F AY N D
DEFINITELY	D EH F AH N AH T L IY
DELIBERATE	D IH L IH B ER AH T
DELIBERATE(2)	D IH L IH B ER EY T
DELIBERATE(3)	D IH L IH B R AH T
DELIBERATE.	D IH L IH B AH R AH T
DELIBERATELY	D IH L IH B ER AH T L IY
DELIBERATELY(2)	D IH L IH B R AH T L IY
DELIGHTED	D IH L AY T AH D
DELIGHTED(2)	D IH L AY T IH D
DELIGHTFUL	D IH L AY T F AH L
DELIVER	D IH L IH V ER
DELIVERED	D IH L IH V ER D
DELIVERING	D IH L IH V ER IH NG
DELIVERY	D IH L IH V ER IY
DELL'ORCO""	D IH L AO R K OW
DELL'ORCO"",	D IH L AO R K OW
DEMAND	D IH M AE N D
DEMON	D IY M AH N
DEMON,	D IY M AH N
DEMONIC	D IH M AA N IH K
DEMONS	D IY M AH N Z
DEMONS,	D IY M AH N Z
DEMONS...FOR	D IY M AH N Z F AO R
DEMONSTRATE	D EH M AH N S T R EY T
DENNIS	D EH N IH S
DENSITY	D EH N S AH T IY
DENSITY(2)	D EH N S IH T IY
DENZEL	D EH N Z AH L
DEPICT	D IH P IH K T
DEPRESSED	D IH P R EH S T
DEPT.	D EH P T
DEPTH	D EH P TH
DEPUTY	D EH P Y AH T IY
DEPUTY(2)	D EH P Y UW T IY
DERANGEMENT	D IY R EY N JH M AH N T
DESECRATED	D EH Z AH K R EY T IH D
DESECRATED(2)	D EH S AH K R EY T IH D
DESERT	D EH Z ER T
DESERT(2)	D IH Z ER T
DESERTED	D IH Z ER T IH D
DESERVE,	D IH Z ER V
DESERVED,	D IH Z ER V D
DESERVES	D IH Z ER V Z
DESIGNED	D IH Z AY N D
DESIGNED,	D IH Z AY N D
DESOLATE,	D EH S AH L AH T
DESPISED	D IH S P AY Z D
DESPISED,	D IH S P AY Z D
DESPITE	D IH S P AY T
DESTINY	D EH S T AH N IY
DESTINY---HIS	D EH S T AH N IY
DETAIL	D IH T EY L
DETAIL(2)	D IY T EY L
DETAILED	D IH T EY L D
DETAILED,	D IH T EY L D
DETECTIVE	D IH T EH K T IH V
DETERRED	D IH T ER D
DETROIT,WHEN	D IH T R OY T W EH N
DEVELOPED	D IH V EH L AH P T
DEVELOPED,	D IH V EH L AH P T
DEVELOPER	D IH V EH L AH P ER
DEVELOPING	D IH V EH L AH P IH NG
DEVELOPMENT,	D IH V EH L AH P M AH N T
DEVELOPS	D IH V EH L AH P S
DIALOG	D AY AH L AO G
DIALOG,	D AY AH L AH G
DIALOGUE	D AY AH L AO G
DIAMOND	D AY M AH N D
DICK	D IH K
DICTATORSHIP	D IH K T EY T ER SH IH P
DID	D IH D
DID.	D IH D
DIDN'T	D IH D AH N T
DIDN'T(2)	D IH D N T
DIDN'T(3)	D IH D AH N
DIDN'T(4)	D IH N T
DIE	D AY
DIE.	D AY
DIE.'---THE	D AY
DIED.	D AY D
DIES	D AY Z
DIFFERENCE	D IH F ER AH N S
DIFFERENCE(2)	D IH F R AH N S
DIFFERENT	D IH F ER AH N T
DIFFERENT(2)	D IH F R AH N T
DIFFERENT,	D IH F ER AH N T
DIFFICULT	D IH F AH K AH L T
DIGGERS	D IH G ER Z
DIME	D AY M
DIMENSION	D IH M EH N SH AH N
DIMENSIONAL.	D AH M EH N CH AH N AH L
DIMINISH,	D AH M IH N IH SH
DINER	D AY N ER
DIRECTED	D ER EH K T AH D
DIRECTED(2)	D ER EH K T IH D
DIRECTED(3)	D AY R EH K T IH D
DIRECTED(4)	D IH R EH K T IH D
DIRECTING	D ER EH K T IH NG
DIRECTING(2)	D IY R EH K T IH NG
DIRECTING(3)	D AY R EH K T IH NG
DIRECTING(4)	D IH R EH K T IH NG
DIRECTING.	D AH R EH K T IH NG
DIRECTION	D ER EH K SH AH N
DIRECTION(2)	D IY R EH K SH IH N
DIRECTION(3)	D AY R EH K SH IH N
DIRECTION(4)	D IH R EH K SH IH N
DIRECTION,	D AH R EH K SH AH N
DIRECTOR	D ER EH K T ER
DIRECTOR(2)	D AY R EH K T ER
DIRECTOR(3)	D IY R EH K T ER
DIRECTOR(4)	D IH R EH K T ER
DIRECTOR!	D AH R EH K T ER
DIRECTOR,	D AH R EH K T ER
DIRECTOR.	D AH R EH K T ER
DIRECTOR/WRITER/MAIN	D AH R EH K T ER R AY T ER M EY N
DIRECTORIAL	D ER EH K T AO R IY AH L
DIRECTORIAL(2)	D AY R EH K T AO R IY AH L
DIRECTORIAL(3)	D IY R EH K T AO R IY AH L
DIRECTORIAL(4)	D IH R EH K T AO R IY AH L
DIRECTORS	D ER EH K T ER Z
DIRECTORS(2)	D AY R EH K T ER Z
DIRECTORS(3)	D IY R EH K T ER Z
DIRECTORS(4)	D IH R EH K T ER Z
DISAGREE,	D IH S AH G R IY
DISAPPEAR	D IH S AH P IH R
DISAPPEAR(2)	D IH S AH P IY R
DISAPPEARED.	D IH S AH P IH ER D
DISAPPEARS.	D IH S AH P IH ER Z
DISAPPOINTED	D IH S AH P OY N T IH D
DISAPPOINTED(2)	D IH S AH P OY N IH D
DISAPPOINTED,	D IH S AH P OY N T IH D
DISAPPOINTED.",9,POS	D IY AY EH S EY P IY P IY OW AY EH N T IY IY D IY N AY N P IY OW EH S
DISARMING	D IH S AA R M IH NG
DISASTER,	D IH Z AE S T ER
DISASTER.ONE	D IH Z AE S T ER W AH N
DISASTERS	D IH Z AE S T ER Z
DISASTROUS	D IH Z AE S T R AH S
DISCO),	D IH S OW
DISCONNECTED	D IH S K AH N EH K T IH D
DISCONTINUE	D IH S K AH N T IH N Y UW
DISCOVER	D IH S K AH V ER
DISEASE.	D IH Z IY Z
DISEASES	D IH Z IY Z AH Z
DISEASES(2)	D IH Z IY Z IH Z
DISENFRANCHISED	D IH S IH N F R AE N CH AY Z D
DISMAL	D IH Z M AH L
DISNEY	D IH Z N IY
DISNEY'S	D IH Z N IY Z
DISPLAY	D IH S P L EY
DISTRESSED	D IH S T R EH S T
DISTRICTS	D IH S T R IH K T S
DISTURBED.	D IH S T ER B D
DISTURBING,	D IH S T ER B IH NG
DJ	D IY JH
DJAFARIDZE,SESILIA	JH AE F AH R AH D Z S AH S IH L Y AH
DO	D UW
DO.",10,POS	D IY OW W AH N Z IY R OW P IY OW EH S
DOCTOR	D AA K T ER
DOCTOR(2)	D AO K T ER
DOCTOR'S	D AA K T ER Z
DOCTRINES	D AA K T R AH N Z
DOCUMENTARIES	D AA K Y AH M EH N T ER IY Z
DOCUMENTARIES(2)	D AA K Y AH M EH N ER IY Z
DOCUMENTARIES(3)	D AA K Y UW M EH N T ER IY Z
DOCUMENTARIES(4)	D AA K Y UW M EH N ER IY Z
DOCUMENTARY	D AA K Y AH M EH N T ER IY
DOCUMENTARY(2)	D AA K Y AH M EH N ER IY
DOCUMENTARY(3)	D AA K Y UW M EH N T ER IY
DOCUMENTARY(4)	D AA K Y UW M EH N ER IY
DODGY	D AA JH IY
DOES	D AH Z
DOES(2)	D IH Z
DOESN'T	D AH Z AH N T
DOESN'T(2)	D AH Z AH N
DOG	D AO G
DOING	D UW IH NG
DON	D AA N
DON'T	D OW N T
DON'T(2)	D OW N
DONE	D AH N
DONE,	D AH N
DONE.	D AH N
DOOLEY	D UW L IY
DOOLEY'S	D UW L IY Z
DOOR-TO-DOOR	D AO R T UW D AO R
DOORS	D AO R Z
DOPPELGANGER	D AA P EH L G AH NG AH R
DOUBT,	D AW T
DOUBT.	D AW T
DOUBTS	D AW T S
DOWN	D AW N
DOWNSIDE	D AW N S AY D
DOZEN,	D AH Z AH N
DOZENS	D AH Z AH N Z
DRAG	D R AE G
DRAGON,	D R AE G AH N
DRAMA	D R AA M AH
DRAMA,	D R AA M AH
DRAMAS	D R AA M AH Z
DRAMATIC	D R AH M AE T IH K
DREAMLIKE	D R IY M L AY K
DRESS	D R EH S
DRESSED	D R EH S T
DRESSES	D R EH S AH Z
DRESSES(2)	D R EH S IH Z
DREW	D R UW
DREWS	D R UW Z
DRIFTER	D R IH F T ER
DRILL	D R IH L
DRIVE	D R AY V
DRIVE-IN,	D R AY V IH N
DRIVER	D R AY V ER
DRONE	D R OW N
DRUG	D R AH G
DRUNK,	D R AH NG K
DUBBED	D AH B D
DUBBING	D AH B IH NG
DUE	D UW
DUE(2)	D Y UW
DUG	D AH G
DULL,	D AH L
DUMB	D AH M
DUNDEE	D AH N D IY
DURING	D UH R IH NG
DURING(2)	D Y UH R IH NG
DURING(3)	D ER IH NG
DUSK	D AH S K
DUSTIN	D AH S T IH N
DVD	D IY V IY D IY
DVD!	D IY V IY D IY
DVD,	D IY V IY D IY
DVD.I	D V D AY
DWELLERS	D W EH L ER Z
DWIGHT	D W AY T
DYING	D AY IH NG
DYLAN	D IH L AH N
DYLAN'S	D IH L AH N Z
DéJà	D IY JH EY
E,	
EA	IY AH
EACH	IY CH
EAGERLY	IY G ER L IY
EARLIER	ER L IY ER
EARLIER.	ER L IY ER
EARLIEST	ER L IY AH S T
EARLY	ER L IY
EARLY.	ER L IY
EARSHOT,	IH ER SH AA T
EARTH	ER TH
EARTH,	ER TH
EARTH-SHATTERING	ER TH SH AE T ER IH NG
EARTHLY	ER TH L IY
EASE	IY Z
EASILY	IY Z AH L IY
EASILY.GRANTED,	IY Z IY L IY G R AE N T IH D
EAST)	IY S T
EASY	IY Z IY
EASY,	IY Z IY
EASYGOING	IY Z IY G OW IH NG
EATING	IY T IH NG
EATING,EATING	IY T IH NG IY T IH NG
EATING.IN	IY T IH NG IH N
ECONOMY	IH K AA N AH M IY
ECONOMY(2)	IY K AA N AH M IY
EDGE	EH JH
EDITED	EH D AH T AH D
EDITED(2)	EH D IH T IH D
EDITED;	EH D AH T IH D
EDITING	EH D AH T IH NG
EDITING(2)	EH D IH T IH NG
EDITING,	EH D AH T IH NG
EDO	IY D OW
EDO,	EH D OW
EDWARD	EH D W ER D
EFFECT	IH F EH K T
EFFECT(2)	IY F EH K T
EFFECT(3)	AH F EH K T
EFFECTIVE	IH F EH K T IH V
EFFECTIVE(2)	IY F EH K T IH V
EFFECTIVE,	IH F EH K T IH V
EFFECTS	IH F EH K T S
EFFECTS(2)	IH F EH K S
EFFECTS(3)	IY F EH K T S
EFFECTS(4)	IY F EH K S
EFFORTS	EH F ER T S
EGGS	EH G Z
EGLANTINE	EH G L AH N T AY N
EGLIMATA	EH G L IH M AH T AH
EGO,	IY G OW
EIGHTIES,	EY T IY Z
EITHER	IY DH ER
EITHER(2)	AY DH ER
EITHER.	IY DH ER
ELDERLY	EH L D ER L IY
ELDEST	EH L D AH S T
ELECTED	IH L EH K T AH D
ELECTED(2)	IH L EH K T IH D
ELECTION	IH L EH K SH AH N
ELEMENTS	EH L AH M AH N T S
ELEVATES	EH L AH V EY T S
ELEVEN-	IH L EH V AH N
ELITE	IH L IY T
ELITE(2)	EY L IY T
ELSE	EH L S
ELSE.	EH L S
ELSEWHERE	EH L S W EH R
EMBARRASSED	IH M B EH R AH S T
EMILIA	AH M IY L IY AH
EMINENT	EH M AH N AH N T
EMMA	EH M AH
EMMA.	IH M AA
EMOTION	IH M OW SH AH N
EMOTION(2)	IY M OW SH AH N
EMOTIONAL	IH M OW SH AH N AH L
EMOTIONAL(2)	IY M OW SH AH N AH L
EMOTIONALLY	IH M OW SH N AH L IY
EMOTIONALLY(2)	IY M OW SH N AH L IY
EMOTIONS	IH M OW SH AH N Z
EMOTIONS:	IH M OW SH AH N Z
EMPHASIZE	EH M F AH S AY Z
EMPLOYER	EH M P L OY ER
EMPLOYER(2)	IH M P L OY ER
EMPLOYERS,	IH M P L OY IY ER Z
EMULATE	EH M Y AH L EY T
EN	EH N
ENCHANTED	EH N CH AE N T IH D
ENCHANTED(2)	EH N CH AE N IH D
ENCOUNTER	IH N K AW N T ER
ENCOUNTER(2)	IH N K AW N ER
ENCOUNTERED	IH N K AW N T ER D
ENCOUNTERED(2)	IH N K AW N ER D
ENCOUNTERS	IH N K AW N T ER Z
ENCOUNTERS(2)	IH N K AW N ER Z
ENCOUNTERS.	IH N K AW N T ER Z
END	EH N D
END,	EH N D
END.	EH N D
ENDEAVORING	IH N D EH V ER IH NG
ENDEAVORING(2)	IH N D EH V R IH NG
ENDED	EH N D AH D
ENDED(2)	EH N D IH D
ENDING	EH N D IH NG
ENDING!	EH N D IH NG
ENDINGS	EH N D IH NG Z
ENDLESS	EH N D L AH S
ENDS	EH N D Z
ENEMIES.IF	EH N AH M IY Z IH F
ENEMY,	EH N AH M IY
ENFORCEMENT,	EH N F OW R S M AH N T
ENGLAND	IH NG G L AH N D
ENGLAND,	IH NG G L AH N D
ENGLISH	IH NG G L IH SH
ENGLISH(2)	IH NG L IH SH
ENGROSSED	IH N G R OW S T
ENHANCING	EH N HH AE N S IH NG
ENJOY	EH N JH OY
ENJOY,	EH N JH OY
ENJOY.",9,POS	IY EH N JH EY OW W AY N AY N P IY OW EH S
ENJOYABLE	EH N JH OY AH B AH L
ENJOYED	EH N JH OY D
ENJOYS	EH N JH OY Z
ENOUGH	IH N AH F
ENOUGH(2)	IY N AH F
ENSEMBLE	AA N S AA M B AH L
ENSUES,	IH N S UW Z
ENTER	EH N T ER
ENTER(2)	EH N ER
ENTERED	EH N T ER D
ENTERED(2)	EH N ER D
ENTERPRISE	EH N T ER P R AY Z
ENTERPRISE(2)	EH N ER P R AY Z
ENTERTAINED	EH N T ER T EY N D
ENTERTAINED(2)	EH N ER T EY N D
ENTERTAINING	EH N T ER T EY N IH NG
ENTERTAINING(2)	EH N ER T EY N IH NG
ENTERTAINMENT	EH N T ER T EY N M AH N T
ENTERTAINMENT(2)	EH N ER T EY N M AH N T
ENTERTAINMENT'---YET	EH N T ER T EY N M AH N T
ENTERTAINMENT.	EH N T ER T EY N M AH N T
ENTHRALLING,	IH N TH R AO L IH NG
ENTHUSIAST	EH N TH UW Z IY AE S T
ENTIRE	IH N T AY ER
ENTIRETY.GONE	IH N T AY R AH T IY G AO N
ENVY	EH N V IY
ENVY(EVIDENCED	EH N V IY EH V AH D AH N S T
ENVY,	EH N V IY
ENVY?	EH N V IY
EPIC	EH P IH K
EPIC,	EH P IH K
EPISODE	EH P IH S OW D
EPISODE,	EH P AH S OW D
EPISODE.	EH P AH S OW D
EPISODES	EH P IH S OW D Z
EPISODES,	EH P AH S OW D Z
EQUALLY	IY K W AH L IY
EQUIPMENT.	IH K W IH P M AH N T
ERA	EH R AH
ERA(2)	IH R AH
ERA,	IH R AH
ERA.	IH R AH
ERA.OVERALL	IH R AH OW V ER AO L
ERAS	IH R AH Z
ERAS.	IH R AH Z
ERIC	EH R IH K
ESCAPE	IH S K EY P
ESOTERICS	EH S AH T EH R IH K S
ESPECIAL	AH S P EH SH AH L
ESPECIALLY	AH S P EH SH L IY
ESPECIALLY(2)	AH S P EH SH AH L IY
ESSENCE	EH S AH N S
ESSENTIALLY	EH S EH N SH AH L IY
ESSENTIALLY(2)	IY S EH N SH AH L IY
ESTATE	EH S T EY T
ESTES,	EH S T S
ESTHETICS	EH S TH EH T IH K S
ESTIMATE	EH S T AH M AH T
ESTIMATE(2)	EH S T AH M EY T
ETC...	EH T
ETC.WHAT	EH T W AA T
ETERNITY,	IH T ER N AH T IY
EVACUATE	IH V AE K Y AH EY T
EVACUATE(2)	IY V AE K Y AH EY T
EVACUATION,	IH V AE K Y AH W EY SH AH N
EVEN	IY V IH N
EVENT	IH V EH N T
EVENT(2)	IY V EH N T
EVENTS	IH V EH N T S
EVENTS(2)	IY V EH N T S
EVENTUALLY	IH V EH N CH AH W AH L IY
EVENTUALLY(2)	IH V EH N SH AH L IY
EVENTUALLY(3)	IY V EH N CH AH W AH L IY
EVENTUALLY(4)	IY V EH N SH AH L IY
EVER	EH V ER
EVER!!!""	EH V ER
EVER!ACTORS	EH V ER AE K T ER Z
EVER.	EH V ER
EVERETT	EH V ER AH T
EVERETT(2)	EH V R AH T
EVERY	EH V ER IY
EVERY(2)	EH V R IY
EVERYDAY	EH V R IY D EY
EVERYMAN,	IY V AH R IY M AE N
EVERYONE	EH V R IY W AH N
EVERYONE,	EH V R IY W AH N
EVERYONE.	EH V R IY W AH N
EVERYTHING	EH V R IY TH IH NG
EVERYWHERE	EH V R IY W EH R
EVERYWHERE(2)	EH V R IY HH W EH R
EVGENI	EH V AH N IY
EVIDENCES.	EH V AH D AH N S IH Z
EVIL	IY V AH L
EVOLVED	IH V AA L V D
EVOLVED(2)	IY V AA L V D
EX-TEAMMATE	EH K S T IY M EY T
EXACTLY	IH G Z AE K T L IY
EXAMPLE	IH G Z AE M P AH L
EXAMPLE,	IH G Z AE M P AH L
EXAMPLES.	IH G Z AE M P AH L Z
EXCEEDED	IH K S IY D AH D
EXCEEDED(2)	IH K S IY D IH D
EXCELLENCE	EH K S AH L AH N S
EXCELLENT	EH K S AH L AH N T
EXCELLENT,	EH K S AH L AH N T
EXCELLENTLY	EH K S AH L AH N T L IY
EXCELLENTLY,	EH K S AH L AH N T L IY
EXCEPT	IH K S EH P T
EXCEPTIONS).WATCH	IH K S EH P SH AH N Z W AA CH
EXCHANGE	IH K S CH EY N JH
EXCITING	IH K S AY T IH NG
EXCLUSIVELY	IH K S K L UW S IH V L IY
EXILED	EH G Z AY L D
EXILED(2)	EH K S AY L D
EXONERATED.I	IH G Z AA N AH R EY T IH D AY
EXPANSIVE	IH K S P AE N S IH V
EXPECT	IH K S P EH K T
EXPECTATIONS	EH K S P EH K T EY SH AH N Z
EXPECTATIONS,	IH K S P EH K T EY SH AH N Z
EXPECTATIONS.	IH K S P EH K T EY SH AH N Z
EXPECTED	IH K S P EH K T AH D
EXPECTED(2)	IH K S P EH K T IH D
EXPECTED,	IH K S P EH K T IH D
EXPECTING	IH K S P EH K T IH NG
EXPENSE	IH K S P EH N S
EXPENSIVE	IH K S P EH N S IH V
EXPERIENCED	IH K S P IH R IY AH N S T
EXPERIENCES.	IH K S P IH R IY AH N S IH Z
EXPERT.	EH K S P ER T
EXPERTLY	EH K S P ER T L IY
EXPLAIN	IH K S P L EY N
EXPLAINS	IH K S P L EY N Z
EXPLANATION:	EH K S P L AH N EY SH AH N
EXPLODE	IH K S P L OW D
EXPLOITATION.TAKE	EH K S P L OY T EY SH AH N T EY K
EXPLORATIONS	EH K S P L ER EY SH AH N Z
EXPLORATIONS(2)	EH K S P L AO R EY SH AH N Z
EXPLORED	IH K S P L AO R D
EXPLOSION.	IH K S P L OW ZH AH N
EXPOSED,	IH K S P OW Z D
EXPRESSING	IH K S P R EH S IH NG
EXPRESSION	IH K S P R EH SH AH N
EXQUISITELY	EH K S K W IH Z IH T L IY
EXTRA	EH K S T R AH
EXTRA-MARITAL	EH K S T R AH M AE R AH T AH L
EXTRAS	EH K S T R AH Z
EXTREME	IH K S T R IY M
EXTREMELY	IH K S T R IY M L IY
EYE	AY
EYE,	AY
EYES	AY Z
EYRE.BY	EY R B AY
EYRED	EY R D
FACE	F EY S
FACE,	F EY S
FACE.UNLIKE	F EY S AH N L AY K
FACED	F EY S T
FACED,	F EY S T
FACILITY	F AH S IH L IH T IY
FACING	F EY S IH NG
FACT	F AE K T
FACT,	F AE K T
FACTOR.	F AE K T ER
FADE	F EY D
FADED	F EY D AH D
FADED(2)	F EY D IH D
FADS,	F AE D Z
FAHEY	F AE HH IY
FAILING	F EY L IH NG
FAILURE	F EY L Y ER
FAIR	F EH R
FAIRLY	F EH R L IY
FAIRY	F EH R IY
FAIRY-TALES.	F EH R IY T EY L Z
FALL	F AO L
FALL(2)	F AA L
FALLING	F AA L IH NG
FALLON	F AE L AH N
FALLS	F AO L Z
FALSE	F AO L S
FAMILIAR	F AH M IH L Y ER
FAMILIAR.	F AH M IH L Y ER
FAMILIES	F AE M AH L IY Z
FAMILIES(2)	F AE M L IY Z
FAMILY	F AE M AH L IY
FAMILY(2)	F AE M L IY
FAMILY,	F AE M AH L IY
FAMOUS.ANYONE	F EY M AH S EH N IY W AH N
FAN	F AE N
FAN.	F AE N
FANNING	F AE N IH NG
FANNING)	F AE N IH NG
FANS	F AE N Z
FANS.	F AE N Z
FANS.",10,POS	EH F EY EH N EH S W AH N Z IY R OW P IY OW EH S
FANTASIA	F AE N T EY ZH AH
FANTASTIC	F AE N T AE S T IH K
FANTASTIC.	F AE N T AE S T IH K
FANTASY	F AE N T AH S IY
FANTASY(2)	F AE N AH S IY
FANTASY/SWORDPLAY	F AE N T AH S IY S OW R D P L EY
FANTASY/SWORDPLAY/COMEDY	F AE N T AH S IY S OW R D P L EY K AA M AH D IY
FAR	F AA R
FAR,	F AA R
FASCINATING	F AE S AH N EY T IH NG
FASHION	F AE SH AH N
FASHION,	F AE SH AH N
FASHIONS,	F AE SH AH N Z
FATALE	F AE T EY L
FATE	F EY T
FATHER	F AA DH ER
FATHER-FIGURE	F AA DH ER F IH G Y ER
FAULTS	F AO L T S
FAVORITE	F EY V ER IH T
FAVORITE(2)	F EY V R AH T
FAVORITES	F EY V ER IH T S
FAVORITES(2)	F EY V R AH T S
FAVOURITE	F EY V ER IH T
FAVOURITES	F AE V AH R AY T S
FEAR	F IH R
FEAR,	F IH ER
FEARED	F IH R D
FEARING	F IH R IH NG
FEARSOME	F IH R S AH M
FEATURE	F IY CH ER
FEATURED	F IY CH ER D
FEATURES	F IY CH ER Z
FEATURES,	F IY CH ER Z
FEDERATION	F EH D ER EY SH AH N
FEEL	F IY L
FEELING	F IY L IH NG
FEELINGS	F IY L IH NG Z
FEELINGS.	F IY L IH NG Z
FEELS	F IY L Z
FELL	F EH L
FELLOW	F EH L OW
FELT	F EH L T
FEMALE	F IY M EY L
FEMME	F EH M
FEND	F EH N D
FEST	F EH S T
FESTIVAL	F EH S T AH V AH L
FESTIVAL(2)	F EH S T IH V AH L
FESTIVAL.	F EH S T IH V AH L
FETCHING.	F EH CH IH NG
FEUDING	F Y UW D IH NG
FEW	F Y UW
FIFTIES,	F IH F T IY Z
FIGHT	F AY T
FIGHT(HELL	F AY T HH EH L
FIGHTING	F AY T IH NG
FIGHTS,	F AY T S
FIGURE	F IH G Y ER
FIGURE.	F IH G Y ER
FILL	F IH L
FILLED	F IH L D
FILM	F IH L M
FILM!	F IH L M
FILM'S	F IH L M Z
FILM).	F IH L M
FILM,	F IH L M
FILM.	F IH L M
FILM.",10,POS	EH F AY EH L EH M W AH N Z IY R OW P IY OW EH S
FILM....THE	F IH L M DH AH
FILM.THE	F IH L M DH AH
FILM:	F IH L M
FILMED	F IH L M D
FILMED.	F IH L M D
FILMING	F IH L M IH NG
FILMMAKERS	F IH L M EY K ER Z
FILMS	F IH L M Z
FILMS,	F IH L M Z
FILMS--HOW	F IH L M Z
FILMS.	F IH L M Z
FILMS.",7,POS	EH F AY EH L EH M EH S EH V AH N P IY OW EH S
FILMS.4/25/08==I	EH F AY EH L EH M EH S F OW R T UW F AY V Z IY R OW EY T
FILMS:	F IH L M Z
FILMSCHOOL,	F IH L M S K UW L
FILTER	F IH L T ER
FINAL	F AY N AH L
FINALE	F AH N AE L IY
FINALIZING	F AY N AH L AY Z IH NG
FINALLY	F AY N AH L IY
FINALLY;	F AY N AH L IY
FIND	F AY N D
FIND.	F AY N D
FINDING	F AY N D IH NG
FINDS	F AY N D Z
FINE	F AY N
FINEST	F AY N AH S T
FINEST.	F AY N AH S T
FINISH	F IH N IH SH
FINISHED.	F IH N IH SH T
FIRE	F AY ER
FIRE(2)	F AY R
FIRE""	F AY ER
FIRE,	F AY ER
FIRES	F AY ER Z
FIRES(2)	F AY R Z
FIRESIDE	F AY ER S AY D
FIRESTORM	F AY R S T AO R M
FIRM	F ER M
FIRST	F ER S T
FIRST.AS	F ER S T AE Z
FITS	F IH T S
FIVE	F AY V
FIX,	F IH K S
FIXATION	F IH K S EY SH AH N
FLAMBOYANT	F L AE M B OY AH N T
FLASHY	F L AE SH IY
FLAT--WE	F L AE T
FLAV,	F L AE V
FLAVA	F L AE V AH
FLAWS	F L AO Z
FLEET	F L IY T
FLEETING,	F L IY T IH NG
FLICK	F L IH K
FLICK,	F L IH K
FLICK.MY	F L IH K M AY
FLLOW	F L OW
FLOODING	F L AH D IH NG
FLOPS.	F L AA P S
FLOW	F L OW
FLOWERS	F L AW ER Z
FLU	F L UW
FLUFFY	F L AH F IY
FLUTE	F L UW T
FLUTE.NOT	F L UW T N AA T
FLYING	F L AY IH NG
FLYING,	F L AY IH NG
FLYING.	F L AY IH NG
FLYNN	F L IH N
FOCH'S	F AA CH AH Z
FOCUS	F OW K AH S
FOCUS(2)	F OW K IH S
FOCUSES	F OW K AH S IH Z
FOCUSES(2)	F OW K IH S IH Z
FOCUSING	F OW K AH S IH NG
FOCUSING(2)	F OW K IH S IH NG
FOIBLES	F OY B AH L Z
FOLKLORE	F OW K L AO R
FOLKS	F OW K S
FOLLOW	F AA L OW
FOLLOWED	F AA L OW D
FOLLOWING	F AA L OW IH NG
FOLLOWS	F AA L OW Z
FOLLOWS,	F AA L OW Z
FONTAINE	F AO N T EY N
FONTAINE'S	F AO N T EY N Z
FOOD!	F UW D
FOODS,	F UW D Z
FOOT""	F UH T
FOOTAGE.",8,POS	EH F OW OW T IY EY JH IY IY EY T P IY OW EH S
FOOTBALL	F UH T B AO L
FOOTBALL.	F UH T B AO L
FOR	F AO R
FOR(2)	F ER
FOR(3)	F R ER
FOR,	F AO R
FORCE	F AO R S
FORCE.	F OW R S
FORCED	F AO R S T
FORCES	F AO R S IH Z
FORESTALL	F AO R S T AO L
FOREVER,	F ER EH V ER
FOREVER.	F ER EH V ER
FORGET	F ER G EH T
FORGET(2)	F AO R G EH T
FORGIVE	F ER G IH V
FORGIVE(2)	F AO R G IH V
FORGOT	F ER G AA T
FORGOT(2)	F AO R G AA T
FORMATIVE	F AO R M AH T IH V
FORMER	F AO R M ER
FORMS	F AO R M Z
FORMULA	F AO R M Y AH L AH
FORMULAIC	F AO R M Y AH L EY IH K
FORTH.	F OW R TH
FORTUNE.	F AO R CH AH N
FORTUNES	F AO R CH AH N Z
FORTUNES(2)	F AO R CH UW N Z
FORWARD	F AO R W ER D
FOUND	F AW N D
FOUR	F AO R
FOURTH	F AO R TH
FOX.	F AA K S
FOXY	F AA K S IY
FRAGMENT	F R AE G M AH N T
FRANCE.	F R AE N S
FRANCES	F R AE N S IH S
FRANK	F R AE NG K
FRANKLIN,	F R AE NG K L AH N
FRANKLY	F R AE NG K L IY
FREAK	F R IY K
FREAKED	F R IY K T
FREAKS	F R IY K S
FREED	F R IY D
FRENCH	F R EH N CH
FRENZY	F R EH N Z IY
FRENZY.	F R EH N Z IY
FREQUENTLY	F R IY K W AH N T L IY
FREQUENTLY(2)	F R IY K W EH N T L IY
FREQUENTS.	F R IY K W AH N T S
FRESH	F R EH SH
FRESHMAN	F R EH SH M AH N
FRESHMAN--IT'S	F R EH SH M AH N
FRIED	F R AY D
FRIED(2)	F R IY D
FRIEND	F R EH N D
FRIENDLY	F R EH N D L IY
FRIENDS	F R EH N D Z
FRIENDS!	F R EH N D Z
FRIENDS,	F R EH N D Z
FROLIC,	F R AA L IH K
FROM	F R AH M
FRONT	F R AH N T
FROZEN	F R OW Z AH N
FRUSTRATING	F R AH S T R EY T IH NG
FULCI'S	F UH L S AH Z
FULFILLED	F UH L F IH L D
FULL	F UH L
FULL-LENGTH	F UH L L EH NG K TH
FULLY	F UH L IY
FUN	F AH N
FUN.	F AH N
FUNDRAISER/SALESMAN.	F AH N D R EY Z ER S EY L Z M AE N
FUNNIER	F AH N IY ER
FUNNIEST	F AH N IY AH S T
FUNNY	F AH N IY
FUNNY,	F AH N IY
FUNNY.	F AH N IY
FURLONG	F ER L AO NG
FURNISHINGS,	F ER N IH SH IH NG Z
FUSS	F AH S
FUTURE	F Y UW CH ER
FUTURE.	F Y UW CH ER
FUZZY	F AH Z IY
GAGS	G AE G Z
GAINED	G EY N D
GALE	G EY L
GALORE-	G AH L AO R
GAME	G EY M
GAME!	G EY M
GAMEPLAY.	G EY M P L EY
GAMES	G EY M Z
GAMES.	G EY M Z
GAMES.I	G EY M Z AY
GANGS.	G AE NG Z
GANGSTER	G AE NG S T ER
GARSH	G AA R SH
GATHER	G AE DH ER
GAVE	G EY V
GAY	G EY
GEM.	JH EH M
GENE	JH IY N
GENERAL	JH EH N ER AH L
GENERAL(2)	JH EH N R AH L
GENERALLY	JH EH N ER AH L IY
GENERALLY(2)	JH EH N R AH L IY
GENERATE	JH EH N ER EY T
GENERIC	JH AH N EH R IH K
GENEROUSLY	JH EH N ER AH S L IY
GENETICS	JH AH N EH T IH K S
GENIUS	JH IY N Y AH S
GENRE	ZH AA N R AH
GENRE'S	ZH AA N R AH Z
GENRE,	ZH AA N R AH
GENRE.	ZH AA N R AH
GENRE.",10,POS	JH IY IY EH N AA R IY W AH N Z IY R OW P IY OW EH S
GENTEEL	JH EH N T IY L
GENUINELY	JH EH N Y UW AH N L IY
GENUINELY(2)	JH EH N Y UW AY N L IY
GENUINENESS	JH EH N Y UW AH N IH S
GEORGE	JH AO R JH
GEORGE,	JH AO R JH
GEORGIA	JH AO R JH AH
GEORGIAN	JH AO R JH AH N
GEORGY	JH AO R JH IY
GERALD/GERALDINE	JH EH R AH L D JH EH R AH L D AY N
GERIATRIC	JH EH R IY AE T R IH K
GERMOGEL)	JH AH R M AH JH AH L
GERSHWIN	G ER SH W IH N
GERSHWIN,	JH AH R SH W AH N
GERSHWINS	JH AH R SH W AH N Z
GET	G EH T
GET(2)	G IH T
GETS	G EH T S
GETS(2)	G IH T S
GETTING	G EH T IH NG
GETTING(2)	G IH T IH NG
GHARANAS	G AE R AH N AH Z
GHOST	G OW S T
GHULAM	G Y UW L AE M
GIANNINI)	JH AY AE N AH N IY
GIFTED,	G IH F T IH D
GIFTS,	G IH F T S
GIGGLES	G IH G AH L Z
GIMMICKS	G IH M IH K S
GINA	JH IY N AH
GINA.	JH IH N AH
GIRL	G ER L
GIRL""	G ER L
GIRL-CHILD,	G ER L CH AY L D
GIRLFRIEND.	G ER L F R EH N D
GIRLHOOD	G ER L HH UH D
GIRLS.	G ER L Z
GIVE	G IH V
GIVEN	G IH V AH N
GIVEN(2)	G IH V IH N
GIVER	G IH V ER
GIVES	G IH V Z
GIVING	G IH V IH NG
GLENN	G L EH N
GLOBAL	G L OW B AH L
GLORY	G L AO R IY
GLORY.	G L OW R IY
GO	G OW
GO,	G OW
GOD	G AA D
GOD'S	G AA D Z
GOD,	G AA D
GOD.	G AA D
GODDESS	G AA D AH S
GODFATHER	G AA D F AA DH ER
GOES	G OW Z
GOES,	G OW Z
GOES...HE	G OW Z HH IY
GOING	G OW IH NG
GOING(2)	G OW IH N
GOLDEN	G OW L D AH N
GONE	G AO N
GONE---SO	G AO N
GOOD	G UH D
GOOD(2)	G IH D
GOOD!	G UH D
GOOD!",7,POS	JH IY OW OW D IY S EH V AH N P IY OW EH S
GOOD,	G UH D
GOOD.	G UH D
GOOD.",7,POS	JH IY OW OW D IY S EH V AH N P IY OW EH S
GOOD.,8,POS	JH IY OW OW D IY EY T P IY OW EH S
GOODHEARTED	G UH D HH AA R T IH D
GOODNIGHT	G UH D N AY T
GOODS,	G UH D Z
GOOFS	G UW F S
GORE	G AO R
GORGEOUS,	G AO R JH AH S
GOT	G AA T
GOTTA	G AA T AH
GOVERNMENT(MANY	G AH V ER N M AH N T M EH N IY
GOWN	G AW N
GPM-GUILTY	JH IY P IY M G IH L T IY
GRACE,	G R EY S
GRADER.	G R EY D ER
GRADUATION.	G R AE JH AH W EY SH AH N
GRAND	G R AE N D
GRAPHICS	G R AE F IH K S
GRASP	G R AE S P
GRASP.	G R AE S P
GRASP.",9,POS	JH IY AA R EY EH S P IY N AY N P IY OW EH S
GRASS	G R AE S
GRATUITOUS	G R AH T UW AH T AH S
GRATUITUS	G R AH T UW T AH S
GRAVE	G R EY V
GRAVEYARD	G R EY V Y AA R D
GRAVITAS	G R AE V AH T AH S
GREAT	G R EY T
GREAT!	G R EY T
GREAT,	G R EY T
GREAT.	G R EY T
GREAT.HELEN	G R EY T HH IY L AH N
GREATEST	G R EY T AH S T
GREATEST.	G R EY T AH S T
GREATS	G R EY T S
GREECE	G R IY S
GREEK	G R IY K
GREEN	G R IY N
GREW	G R UW
GREYTACK,	G R EY T AE K
GRIM	G R IH M
GRIPPING	G R IH P IH NG
GRISBY'S	G R IH S B IY Z
GRISBY,	G R IH Z IY
GRIT.	G R IH T
GROOVE	G R UW V
GROUNDHOG	G R AW N D HH AA G
GROUP	G R UW P
GROUPS	G R UW P S
GROWING,	G R OW IH NG
GUARANTEE	G EH R AH N T IY
GUARD	G AA R D
GUESS	G EH S
GUESS.",7,POS	JH IY Y UW IY EH S EH S EH V AH N P IY OW EH S
GUESS..?THEY	G EH S DH EY
GUEST	G EH S T
GUIDE	G AY D
GUILTY	G IH L T IY
GUITAR	G IH T AA R
GUN,	G AH N
GUNDAM	G AH N D AE M
GUS	G AH S
GUSTO	G AH S T OW
GUSTO.	G AH S T OW
GUY	G AY
GUY,	G AY
GUYS	G AY Z
GUYS!	G AY Z
GUéTARY	G AH T EH R IY
GWYNETH	G W IH N AH TH
H.G.	EY CH JH IY
HAD	HH AE D
HAD.	HH AE D
HADN'T	HH AE D AH N T
HADN'T(2)	HH AE D AH N
HAINES	HH EY N Z
HALF.	HH AE F
HALLIDAY,	HH AE L IH D EY IY
HALLUCINATIONS	HH AH L UW S AH N EY SH AH N Z
HAMLET	HH AE M L AH T
HAMLET(2)	HH AE M L IH T
HAMMY	HH AE M IY
HAMPER	HH AE M P ER
HAND	HH AE N D
HAND,	HH AE N D
HANDFUL	HH AE N D F UH L
HANDLE	HH AE N D AH L
HANDLE.	HH AE N D AH L
HANDLED,	HH AE N D AH L D
HANDLED.	HH AE N D AH L D
HANDS	HH AE N D Z
HANDS(2)	HH AE N Z
HANDS",10,POS	EY CH EY EH N D IY EH S W AH N Z IY R OW P IY OW EH S
HANDSOME	HH AE N S AH M
HANGS	HH AE NG Z
HAPPEN	HH AE P AH N
HAPPEN.",9,POS	EY CH EY P IY P IY IY EH N AY N P IY OW EH S
HAPPENED	HH AE P AH N D
HAPPENED.	HH AE P AH N D
HAPPENING	HH AE P AH N IH NG
HAPPENING(2)	HH AE P N IH NG
HAPPENS	HH AE P AH N Z
HAPPENS).THE	HH AE P AH N Z DH AH
HAPPILY,	HH AE P AH L IY
HAPPY	HH AE P IY
HAPPY.BOTTOM	HH AE P IY B AA T AH M
HARALAMBOPOULOS,	HH AH R AH L AE M B AH P AW L AH Z
HARD	HH AA R D
HAROLD	HH EH R AH L D
HARRIET	HH EH R IY AH T
HARSH	HH AA R SH
HARTLEY	HH AA R T L IY
HARVARD	HH AA R V ER D
HAS	HH AE Z
HAS(2)	HH AH Z
HASN'T	HH AE Z AH N T
HAT	HH AE T
HAT,	HH AE T
HATED	HH EY T AH D
HATED(2)	HH EY T IH D
HAVE	HH AE V
HAVE,	HH AE V
HAVE.	HH AE V
HAVEN'T	HH AE V AH N T
HAVEN'T(2)	HH AE V AH N
HAVING	HH AE V IH NG
HAWAII	HH AH W AY IY
HAWKING'S	HH AO K IH NG Z
HAYWORTH	HH EY W ER TH
HAYWORTH,	HH EY W ER TH
HAZARDOUS	HH AE Z ER D AH S
HAZE	HH EY Z
HE	HH IY
HE'S	HH IY Z
HEADBANGERS	HH EH D B AE NG ER Z
HEADLINE	HH EH D L AY N
HEALTH	HH EH L TH
HEAR	HH IY R
HEARD	HH ER D
HEARFELT	HH IH ER F EH L T
HEARING	HH IY R IH NG
HEART	HH AA R T
HEART.MY	HH AA R T M AY
HEARTED	HH AA R T AH D
HEARTED(2)	HH AA R T IH D
HEAVEN.	HH EH V AH N
HEAVY,	HH EH V IY
HECK	HH EH K
HEEL	HH IY L
HELP	HH EH L P
HELPING	HH EH L P IH NG
HELPS	HH EH L P S
HELPS.	HH EH L P S
HENRI	HH EH N R IY
HENRI(2)	AO R IY
HENRI(3)	AA N R IY
HER	HH ER
HER,	HH ER
HER.	HH ER
HER...	HH ER
HERE	HH IY R
HERE!!SUMMARY:	HH IH ER S AH M EH R IY
HERE,	HH IH ER
HERE.	HH IH ER
HERO.AS	HH IY R OW AE Z
HEROINE	HH EH R OW AH N
HEROINE.	HH EH R AH W AH N
HERSELF,	HH ER S EH L F
HERSELF...	HH ER S EH L F
HETEROSEXUALS).	HH EH T AH R AH S EH K S Y UW AH L Z
HIDING	HH AY D IH NG
HIGH	HH AY
HIGHEST	HH AY AH S T
HIGHLIGHT	HH AY L AY T
HIGHLIGHTING	HH AY L AY T IH NG
HIGHLY	HH AY L IY
HIGHLY.	HH AY L IY
HIGHTOWER	HH AY T AW ER
HILARIOUS	HH IH L EH R IY AH S
HILARIOUS,	HH IH L AE R IY AH S
HILARIOUS.	HH IH L AE R IY AH S
HILL	HH IH L
HILLIARD.	HH IH L IY AH R D
HILTON	HH IH L T AH N
HIM	HH IH M
HIM(2)	IH M
HIM,	HH IH M
HIM.	HH IH M
HIMSELF	HH IH M S EH L F
HIMSELF.LESLIE	HH IH M S EH L F L EH Z L AY
HINDS	HH AY N D Z
HIPNESS,	HH IH P N AH S
HIRED	HH AY ER D
HIS	HH IH Z
HISTORIANS,	HH IH S T OW R IY AH N Z
HISTORIC	HH IH S T AO R IH K
HISTORICAL	HH IH S T AO R IH K AH L
HISTORY	HH IH S T ER IY
HISTORY(2)	HH IH S T R IY
HISTORY.	HH IH S T AH R IY
HIT	HH IH T
HIT-MAN	HH IH T M AE N
HITS	HH IH T S
HODGE-PODGE	HH AA JH P AA JH
HOFFMAN	HH AO F M AH N
HOKEY---WHILE	HH OW K IY
HOLD	HH OW L D
HOLLYWOOD	HH AA L IY W UH D
HOLLYWOOD'S	HH AA L IY W UH D Z
HOLLYWOOD,	HH AA L AH W UW D
HOLLYWOOD.	HH AA L AH W UW D
HOLMES	HH OW M Z
HOLMES(2)	HH OW L M Z
HOLMES.	HH OW M Z
HOMAGE	AA M AH JH
HOMAGE(2)	HH AA M AH JH
HOME	HH OW M
HOME,	HH OW M
HOME.	HH OW M
HOMEMADE	HH OW M M EY D
HOMEMADE(2)	HH OW M EY D
HOMETOWN'S	HH OW M T AW N Z
HOMOSEXUALS	HH OW M OW S EH K SH UW AH L Z
HONEST	AA N AH S T
HONESTLY	AA N AH S T L IY
HONESTLY(2)	AA N AH S L IY
HONESTLY,	AA N AH S T L IY
HONESTY,	AA N AH S T IY
HONG	HH AO NG
HONOR'---'HUMANITY	AA N ER
HONOR.THE	AA N ER DH AH
HONORARY	AA N ER EH R IY
HOOFER'S	HH UW F ER Z
HOPE	HH OW P
HOPES...	HH OW P S
HOPPER).	HH AA P ER
HORRENDOUS	HH AO R EH N D AH S
HORRIBLE	HH AO R AH B AH L
HORRIFIC	HH AO R IH F IH K
HORROR	HH AO R ER
HORROR'	HH AO R ER
HOSTESS.	HH OW S T AH S
HOSTILE	HH AA S T AH L
HOSTILE(2)	HH AA S T AY L
HOSTILITY,	HH AA S T IH L AH T IY
HOUR	AW ER
HOUR(2)	AW R
HOURS	AW ER Z
HOURS(2)	AW R Z
HOURS.	AW ER Z
HOUSE	HH AW S
HOUSE,	HH AW S
HOUSE.	HH AW S
HOW	HH AW
HOWARD,	HH OW AH R D
HOWARD.	HH OW AH R D
HOWEVER	HH AW EH V ER
HOWEVER,	HH AW EH V ER
HUGE	HH Y UW JH
HUGE(2)	Y UW JH
HUGELY	HH Y UW JH L IY
HUMAN	HH Y UW M AH N
HUMAN(2)	Y UW M AH N
HUMAN,	HH Y UW M AH N
HUMANITY?	HH Y UW M AE N AH T IY
HUMANS,	HH Y UW M AH N Z
HUMOR	HH Y UW M ER
HUMOR,	HH Y UW M ER
HUMOUR	HH Y UW M ER
HUNG	HH AH NG
HUNT	HH AH N T
HURLED	HH ER L D
HURT'S	HH ER TS
HURTING	HH ER T IH NG
HUSBAND	HH AH Z B AH N D
HUSBAND,	HH AH Z B AH N D
HYPOCHONDRIAC	HH AY P AH K AA N D R IY AE K
I	AY
I'D	AY D
I'LL	AY L
I'M	AY M
I'M(2)	AH M
I'VE	AY V
I,	AY
IAMASEAL2@YAHOO.COM",10,POS	AY EY EH M EY EH S IY EY EH L T UW W AY EY EY CH OW OW S IY OW EH M W AH N Z IY R OW P IY OW EH S
IAN	IY AH N
ICE	AY S
ICONIC	AY K AA N IH K
IDA	AY D AH
IDEA	AY D IY AH
IDEA.ROCK	AY D IY AH R AA K
IDEAL	AY D IY L
IDENTITY	AY D EH N T AH T IY
IDENTITY,	AY D EH N T AH T IY
IF	IH F
IGNORE	IH G N AO R
ILL	IH L
IMAGE	IH M AH JH
IMAGE(2)	IH M IH JH
IMAGES	IH M AH JH AH Z
IMAGES(2)	IH M IH JH IH Z
IMAGES.	IH M IH JH IH Z
IMAGINATION	IH M AE JH AH N EY SH AH N
IMAGINATIVE	IH M AE JH AH N AH T IH V
IMAGINE	IH M AE JH AH N
IMAX,	IH M AE K S
IMDB	IH M D
IMDBERS,	IH M D EH R Z
IMHO.",7,POS	AY EH M EY CH OW S EH V AH N P IY OW EH S
IMITATE	IH M AH T EY T
IMMATURE	IH M AH T Y UH R
IMMENSELY	IH M EH N S L IY
IMMERSES	IH M ER S IH Z
IMPACT	IH M P AE K T
IMPASSIONED	IH M P AE SH AH N D
IMPERFECTIONS	IH M P ER F EH K SH AH N Z
IMPORTANT	IH M P AO R T AH N T
IMPORTANT,	IH M P OW R T AH N T
IMPOSSIBLE	IH M P AA S AH B AH L
IMPOSSIBLE,	IH M P AA S AH B AH L
IMPOTENT	IH M P AH T AH N T
IMPRESSED	IH M P R EH S T
IMPRESSIONIST	IH M P R EH SH AH N AH S T
IMPRESSIONIST(2)	IH M P R EH SH AH N IH S T
IMPRESSIVE	IH M P R EH S IH V
IN	IH N
IN,	IH N
IN---'WHICH	IH N
IN.CAGNEY	IH N K AE G N IY
IN.THE	IH N DH AH
INABILITY	IH N AH B IH L IH T IY
INCLUDE	IH N K L UW D
INCLUDED	IH N K L UW D AH D
INCLUDED(2)	IH N K L UW D IH D
INCLUDING	IH N K L UW D IH NG
INCOMPARABLE	IH N K AA M P ER AH B AH L
INCOMPREHENSIBLE	IH NG K AA M P R AH HH EH N S IH B AH L
INCREDIBLE	IH N K R EH D AH B AH L
INCREDIBLE,	IH N K R EH D AH B AH L
INCREDIBLY	IH N K R EH D AH B L IY
INDEED	IH N D IY D
INDEED.	IH N D IY D
INDEPENDENT	IH N D IH P EH N D AH N T
INDIAN	IH N D IY AH N
INDIVIDUAL	IH N D AH V IH JH AH W AH L
INDUCED	IH N D UW S T
INDUSTRIALIST	IH N D AH S T R IY AH L IH S T
INEXPENSIVE	IH N IH K S P EH N S IH V
INFAMOUS	IH N F AH M AH S
INFANT	IH N F AH N T
INFESTED	IH N F EH S T IH D
INFLUENCED	IH N F L UW AH N S T
INFLUENTIAL	IH N F L UW EH N SH AH L
INFO	IH N F OW
INFO,	IH N F OW
INFORMATION,	IH N F ER M EY SH AH N
INFORMED	IH N F AO R M D
INGENIOUS.",10,POS	AY EH N JH IY IY EH N AY OW Y UW EH S W AH N Z IY R OW P IY OW EH S
INHABITANTS,	IH N HH AE B AH T AH N T S
INHERIT	IH N HH EH R AH T
INHERITED	IH N HH EH R AH T IH D
INITIAL	IH N IH SH AH L
INNOCENT	IH N AH S AH N T
INNOCENT.	IH N AH S AH N T
INQUISITIVE	IH N K W IH Z IH T IH V
INSATIABLE	IH N S EY SH AH B AH L
INSIDE	IH N S AY D
INSIDE,	IH N S AY D
INSIDE.	IH N S AY D
INSIGHTFUL	IH N S AY T F AH L
INSISTS	IH N S IH S T S
INSPIRED	IH N S P AY ER D
INSTALLMENT	IH N S T AO L M AH N T
INSTALMENTS	IH N S T AO L M AH N T S
INSTANCE,	IH N S T AH N S
INSTANTS	IH N S T AH N T S
INSTEAD	IH N S T EH D
INSTEAD.THE	IH N S T EH D DH AH
INSULT	IH N S AH L T
INSURANCE	IH N SH UH R AH N S
INSURED	IH N SH UH R D
INTELLIGENCE	IH N T EH L AH JH AH N S
INTELLIGENCE.	IH N T EH L AH JH AH N S
INTELLIGENT	IH N T EH L AH JH AH N T
INTENDED	IH N T EH N D IH D
INTENDED,	IH N T EH N D IH D
INTENDS	IH N T EH N D Z
INTENSITY,	IH N T EH N S AH T IY
INTERACTIONS	IH N T ER AE K SH AH N Z
INTERACTIONS(2)	IH N ER AE K SH AH N Z
INTERCUTTING	IH N T ER K AH T IH NG
INTEREST	IH N T AH R EH S T
INTERESTED	IH N T AH R EH S T IH D
INTERESTING	IH N T AH R EH S T IH NG
INTERESTING,	IH N T R AH S T IH NG
INTERESTING.	IH N T R AH S T IH NG
INTERESTING:	IH N T R AH S T IH NG
INTERNATIONAL	IH N T ER N AE SH AH N AA L
INTERNATIONAL(2)	IH N ER N AE SH AH N AA L
INTERNET,	IH N T ER N EH T
INTERPRETATION	IH N T ER P R IH T EY SH AH N
INTERRUPTED	IH N T ER AH P T IH D
INTERTWINE	IH N T ER T W AY N
INTERVENES,	IH N T ER V IY N Z
INTERVIEWS	IH N T ER V Y UW Z
INTO	IH N T UW
INTO(2)	IH N T AH
INTO.	IH N T UW
INTRIGUING	IH N T R IY G IH NG
INTRODUCE	IH N T R AH D UW S
INTRODUCE(2)	IH N T R OW D UW S
INVETERATE	IH N V EH T ER AH T
INVOLVEMENTS	IH N V AA L V M AH N T S
IPOLITE	IH P AH L AY T
IRA	AY R AH
IRA(2)	AY AA R EY
IRAN	IH R AA N
IRAN(2)	AY R AE N
IRANIAN	IH R AA N IY AH N
IRANIAN(2)	AY R EY N IY AH N
IRENE	AY R IY N
IRISH	AY R IH SH
IRONICALLY	AY R AA N IH K L IY
IRONICALLY-DETACHED	AY R AA N IH K L IY D IH T AE CH T
IRRITATING	IH R AH T EY T IH NG
IRRITATING.BUT	IH R AH T EY T IH NG B AH T
IRVING	ER V IH NG
IS	IH Z
IS,	IH Z
IS,(PARAPHRASED)	IH Z P AE R AH F R EY Z D
IS.	IH Z
IS...	IH Z
IS;	IH Z
ISLAND,	AY L AH N D
ISLAND.	AY L AH N D
ISN'T	IH Z AH N T
ISN'T(2)	IH Z AH N
ISSUE	IH SH UW
ISSUES,	IH SH UW Z
IT	IH T
IT!	IH T
IT!",10,POS	AY T IY W AH N Z IY R OW P IY OW EH S
IT'S	IH T S
IT)	IH T
IT).	IH T
IT,	IH T
IT--BUT	IH T
IT.	IH T
IT.""	IH T
IT.",7,POS	AY T IY S EH V AH N P IY OW EH S
IT.",8,POS	AY T IY EY T P IY OW EH S
IT.BRANDO	IH T B R AE N D UW
IT:	IH T
IT?	IH T
ITALIAN	IH T AE L Y AH N
ITS	IH T S
ITSELF	IH T S EH L F
ITSELF,	IH T S EH L F
ITSELF.	IH T S EH L F
IZUMO	AH Z UW M OW
IZUMO,	AH Z UW M OW
IZUMO...SOME	AH Z UW M OW S AH M
IZURUHA,	AH Z UH R AH HH AH
J.T.	JH EY T IY
JACK	JH AE K
JACKSON	JH AE K S AH N
JACKSON'S	JH AE K S AH N Z
JAFAR	JH EY F AH R
JAIL	JH EY L
JAIL?"".	JH EY L
JAKU	JH AE K UW
JAMES	JH EY M Z
JANE	JH EY N
JAPAN	JH AH P AE N
JAPAN.	JH AH P AE N
JAPAN...OH	JH AH P AE N OW
JAPANESE	JH AE P AH N IY Z
JEALOUS	JH EH L AH S
JEANNOT	JH IY N AH T
JEFF	JH EH F
JEREMY	JH EH R AH M IY
JERSEY	JH ER Z IY
JIM,	JH IH M
JIMMY	JH IH M IY
JOAN	JH OW N
JOB	JH AA B
JOB(2)	JH OW B
JOB,	JH AA B
JOBS	JH AA B Z
JOE	JH OW
JOEY	JH OW IY
JOEY,	JH OW IY
JOHN	JH AA N
JOHNSON	JH AA N S AH N
JOHNSON,	JH AA N S AH N
JOKE	JH OW K
JOKES	JH OW K S
JOSEF	JH OW S AH F
JOURNEY	JH ER N IY
JOY	JH OY
JOY,	JH OY
JOYRIDE	JH OY R AY D
JUGGLES	JH AH G AH L Z
JULIET	JH UW L IY EH T
JUNIOR	JH UW N Y ER
JUST	JH AH S T
JUST(2)	JH IH S T
JUSTIFYING	JH AH S T AH F AY IH NG
KABUKI	K AH B UW K IY
KANE),	K EY N
KATE	K EY T
KATHAK	K AE TH AH K
KAVOGIANNI	K AH V OW JH IY AE N IY
KAY	K EY
KEEP	K IY P
KEEPING	K IY P IH NG
KEEPS	K IY P S
KELLY	K EH L IY
KELLY.THE	K EH L IY DH AH
KEN	K EH N
KENNETH	K EH N IH TH
KENNY	K EH N IY
KENTUCKY	K AH N T AH K IY
KEPT	K EH P T
KEPT(2)	K AE P T
KESEY	K S IY
KETTY	K EH T IY
KICK	K IH K
KICK-ASS.IT	K IH K AE S IH T
KICKOFF.	K IH K AO F
KID	K IH D
KID.	K IH D
KIDNAPPED	K IH D N AE P T
KIDNAPPING	K IH D N AE P IH NG
KIDS	K IH D Z
KIDS,	K IH D Z
KILL	K IH L
KILLED	K IH L D
KILLER	K IH L ER
KILLER.	K IH L ER
KILLERS.	K IH L ER Z
KILLING	K IH L IH NG
KILLS	K IH L Z
KILMER	K IH L M ER
KIND	K AY N D
KINDA	K IH N D AH
KINDS	K AY N D Z
KINDS(2)	K AY N Z
KING	K IH NG
KING.	K IH NG
KIRK	K ER K
KIRK,	K AH R K
KITCHEN	K IH CH AH N
KNEW	N UW
KNEW(2)	N Y UW
KNEW,	N UW
KNIFE-	N AY F
KNIGHTLEY,	N AY T L IY
KNOW	N OW
KNOW.",10,POS	K EY EH N OW D AH B AH L Y UW W AH N Z IY R OW P IY OW EH S
KNOW.AND	N OW AE N D
KNOWING	N OW IH NG
KNOWLEDGE	N AA L AH JH
KNOWLEDGE(2)	N AA L IH JH
KNOWN	N OW N
KNOWS	N OW Z
KNOWS),	N OW Z
KONG'S	K AO NG Z
KONG'S(2)	K AO NG G Z
KONSTADINOU	K AA N S T AE D AH N UW
KORDA	K AO R D AH
KORDA'S	K AO R D AH Z
KORDA,	K AO R D AH
KOTE	K OW T
KUDOS	K UW D OW S
KUMAR	K UW M AA R
KUMAR........KAMAL	K Y UW M AH R K EY M AH L
KUMARI	K Y UW M AH R IY
KUMARI'S	K Y UW M AH R AH Z
KUMARI,	K Y UW M AH R IY
LA	L AA
LACK	L AE K
LACKING.	L AE K IH NG
LACKLUSTRE	L AE K L AH S T ER
LACKS	L AE K S
LADIES	L EY D IY Z
LADY	L EY D IY
LADY-LIKE...NO	L EY D IY L AY K N OW
LAMBERTO	L AA M B EH R T OW
LAME	L EY M
LANDIS,	L AE N D IY Z
LANDS.	L AE N D Z
LAND	L AE N D
LANGUAGE	L AE NG G W AH JH
LANGUAGE(2)	L AE NG G W IH JH
LANSBURY	L AE N Z B ER IY
LANSBURY'S	L AE N Z B ER IY Z
LARGE	L AA R JH
LARGER	L AA R JH ER
LAST	L AE S T
LATE	L EY T
LATELY,	L EY T L IY
LATER	L EY T ER
LATER,	L EY T ER
LATER.	L EY T ER
LATEST	L EY T AH S T
LATTER	L AE T ER
LAUGH	L AE F
LAUGH.	L AE F
LAUGHED	L AE F T
LAUGHING	L AE F IH NG
LAUGHING.EVERY	L AE F IH NG EH V R IY
LAUGHS,	L AE F S
LAUGHS.	L AE F S
LAUGHTER,	L AE F T ER
LAW	L AO
LAW(2)	L AA
LAWS	L AO Z
LAWYERS	L AO Y ER Z
LAWYERS(2)	L OY ER Z
LAZERS	L EY Z ER Z
LEAD	L EH D
LEAD(2)	L IY D
LEADER	L IY D ER
LEADING	L IY D IH NG
LEARN	L ER N
LEARNING	L ER N IH NG
LEARNS	L ER N Z
LEARY	L IH R IY
LEAST	L IY S T
LEAST).	L IY S T
LEAST,	L IY S T
LEAST.	L IY S T
LEAVE	L IY V
LEAVE.	L IY V
LEAVES	L IY V Z
LEAVING	L IY V IH NG
LED	L EH D
LEFT	L EH F T
LEFTOVER	L EH F T OW V ER
LEGAL	L IY G AH L
LEGS	L EH G Z
LEISURELY	L IY Z ER L IY
LENGTHY	L EH NG TH IY
LEONARDO	L IY AH N AA R D OW
LEONOV	L IY AH N AH V
LESBIAN	L EH Z B IY AH N
LESS	L EH S
LESSER	L EH S ER
LESSON	L EH S AH N
LESSONS,BUT	L EH S AH N Z B AH T
LET	L EH T
LET'S	L EH T S
LETTING	L EH T IH NG
LEVANT	L AH V AE N T
LEVEL,	L EH V AH L
LEVEL.	L EH V AH L
LEVELS	L EH V AH L Z
LIBERALLY,	L IH B ER AH L IY
LIBRARIAN'S	L AY B R EH R IY AH N Z
LIBRARIAN.	L AY B R EH R IY AH N
LIBRARIAN.THE	L AY B R EH R IY AH N DH AH
LIBRARY.	L AY B R EH R IY
LIE	L AY
LIED	L AY D
LIES	L AY Z
LIFE	L AY F
LIFE!	L AY F
LIFE""	L AY F
LIFE'.	L IH F AH
LIFE,	L AY F
LIFE.	L AY F
LIFE...	L AY F
LIFE.PERHAPS	L AY F P ER HH AE P S
LIFE.THE	L AY F DH AH
LIGHT	L AY T
LIGHT,	L AY T
LIKABLE	L AY K AH B AH L
LIKABLE,	L AY K AH B AH L
LIKABLE.THE	L AY K AH B AH L DH AH
LIKE	L AY K
LIKED	L AY K T
LIKED.	L AY K T
LIKELY	L AY K L IY
LINDSAY	L IH N D Z IY
LINDSAY.	L IH N D S EY IY
LINE	L AY N
LINE"",	L AY N
LINE.",10,POS	EH L AY EH N IY W AH N Z IY R OW P IY OW EH S
LINE;	L AY N
LINES	L AY N Z
LINES,	L AY N Z
LINES.	L AY N Z
LIOTTA	L IY OW T AH
LISA	L IY S AH
LISTENER	L IH S AH N ER
LISTENER(2)	L IH S N ER
LITTLE	L IH T AH L
LITTLE,	L IH T AH L
LITTLE.",9,POS	EH L AY T IY T IY EH L IY N AY N P IY OW EH S
LIVE	L AY V
LIVE(2)	L IH V
LIVED	L IH V D
LIVED(2)	L AY V D
LIVES	L IH V Z
LIVES(2)	L AY V Z
LIVES,	L IH V Z
LIVING	L IH V IH NG
LLOYD	L OY D
LLOYD'S	L OY D Z
LOCAL	L OW K AH L
LONG	L AO NG
LONG,	L AO NG
LONG.	L AO NG
LONGER	L AO NG G ER
LONGER.	L AO NG G ER
LOOK	L UH K
LOOK.	L UH K
LOOKED	L UH K T
LOOKING	L UH K IH NG
LOOKING.	L UH K IH NG
LOOKS	L UH K S
LOONY,	L UW N IY
LORD	L AO R D
LOSE	L UW Z
LOSER	L UW Z ER
LOSER,	L UW Z ER
LOSES	L UW Z IH Z
LOSING	L UW Z IH NG
LOST	L AO S T
LOST"".	L AO S T
LOST,SO	L AO S T S OW
LOST.",10,POS	EH L OW EH S T IY W AH N Z IY R OW P IY OW EH S
LOT	L AA T
LOT(2)	L AO T
LOT!!",10,POS	EH L OW T IY W AH N Z IY R OW P IY OW EH S
LOT.	L AA T
LOTS	L AA T S
LOTTERY,	L AA T AH R IY
LOUD	L AW D
LOUIS	L UW IH S
LOUIS(2)	L UW IY
LOVABLENESS,	L AH V AH B AH L N AH S
LOVE	L AH V
LOVE,	L AH V
LOVE-STORY	L AH V S T AO R IY
LOVE...AND	L AH V AE N D
LOVED	L AH V D
LOVELIER	L AH V L IY ER
LOVELIER'?	L AA V AH L IY R
LOVELY	L AH V L IY
LOVER,	L AH V ER
LOVERS	L AH V ER Z
LOVES	L AH V Z
LOVING	L AH V IH NG
LOW	L OW
LOWER	L OW ER
LOWLIFES	L OW L AY F S
LUCIO	L UW S IY OW
LUCKY	L AH K IY
LUNG	L AH NG
LUSH.	L AH SH
LUSTING	L AH S T IH NG
LYLE	L AY L
LYNCH	L IH N CH
LYRICISM	L IH R IH S IH Z AH M
LYRICIST	L IH R IH S IH S T
M.	EH M
MADE	M EY D
MADE,	M EY D
MAGIC	M AE JH IH K
MAGICAL	M AE JH IH K AH L
MAGNIFICENT	M AE G N IH F AH S AH N T
MAGNIFICENT(2)	M AE G N IH F IH S AH N T
MAIL,	M EY L
MAIN	M EY N
MAINLY	M EY N L IY
MAJOR	M EY JH ER
MAJORITY	M AH JH AO R AH T IY
MAKE	M EY K
MAKES	M EY K S
MAKING	M EY K IH NG
MALE	M EY L
MALEFICENT,	M AH L AH F IH S AH N T
MALEVOLENT	M AH L EH V AH L AH N T
MAN	M AE N
MAN,	M AE N
MAN,""	M AE N
MAN.	M AE N
MANAGE	M AE N AH JH
MANAGE(2)	M AE N IH JH
MANAGE.THE	M AE N IH JH DH AH
MANAGES	M AE N IH JH IH Z
MANGA.	M AE N G AH
MANHATTAN	M AE N HH AE T AH N
MANIAC.	M EY N IY AE K
MANIPULATE	M AH N IH P Y AH L EY T
MANIPULATION	M AH N IH P Y AH L EY SH AH N
MANN.",8,POS	EH M EY EH N EH N EY T P IY OW EH S
MANNER	M AE N ER
MANNER,	M AE N ER
MANY	M EH N IY
MANZANO	M AA N Z AA N OW
MARCO	M AA R K OW
MARIA	M ER IY AH
MARIETTE	M EH R IY EH T
MARINE	M ER IY N
MARK	M AA R K
MARKET	M AA R K AH T
MARKET(2)	M AA R K IH T
MARLON	M AA R L AH N
MARRIED	M EH R IY D
MARRIES	M EH R IY Z
MARTIAL	M AA R SH AH L
MARTIN	M AA R T AH N
MARTIN(2)	M AA R T IH N
MARY	M EH R IY
MARY.	M EH R IY
MARYLAND	M EH R AH L AH N D
MASKED	M AE S K T
MASSACRE	M AE S AH K ER
MASSACRE.IZUMO	M AE S IH K ER AH Z UW M OW
MASSES	M AE S AH Z
MASSES(2)	M AE S IH Z
MASSEY'S	M AE S IY Z
MASTER	M AE S T ER
MASTERFUL	M AE S T ER F AH L
MASTERLY	M AE S T ER L IY
MASTERPIECE	M AE S T ER P IY S
MASTERPIECE).	M AE S T ER P IY S
MASTERPIECE,	M AE S T ER P IY S
MASTERPIECE.	M AE S T ER P IY S
MASTERPIECE.GRADE:	M AE S T ER P IY S G R EY D
MASTERPIECES	M AE S T ER P IY S AH Z
MASTERPIECES(2)	M AE S T ER P IY S IH Z
MASTERS	M AE S T ER Z
MASTERSON)WANTED	M AE S T ER S AH N W AO N T IH D
MATCH	M AE CH
MATERIAL	M AH T IH R IY AH L
MATT	M AE T
MATTER	M AE T ER
MATTER)	M AE T ER
MATTERED	M AE T ER D
MATURE	M AH CH UH R
MATURE(2)	M AH T Y UH R
MATURELY,	M AH T Y UH R L IY
MAURICE	M AO R IY S
MAURICE(2)	M AA R IH S
MAX	M AE K S
MAY	M EY
MAYBE	M EY B IY
MAYER	M EY ER
MAYER,	M EY ER
MAYOR	M EY ER
MCBAIN	M AH K B EY N
MCCOY	M AH K OY
MCKENZIE,	M K EH N Z AY
ME	M IY
ME,	M IY
ME.",10,POS	EH M IY W AH N Z IY R OW P IY OW EH S
ME.THIS	M IY DH IH S
MEAN	M IY N
MEANING,	M IY N IH NG
MEANS	M IY N Z
MEAT	M IY T
MEDIA	M IY D IY AH
MEDIA,	M IY D IY AH
MEDIATION	M IY D IY EY SH AH N
MEEK,	M IY K
MEENA	M IY N AH
MEENA'S	M IY N AH Z
MEET	M IY T
MEET....IN	M IY T IH N
MEETING	M IY T IH NG
MEETS	M IY T S
MELANGE	M EH L AE NG
MELODIES	M EH L AH D IY Z
MELODRAMA,	M EH L AH D R AA M AH
MEMBER	M EH M B ER
MEMBER,	M EH M B ER
MEMBERS	M EH M B ER Z
MEMORABLE	M EH M ER AH B AH L
MEMORY.	M EH M AH R IY
MEN	M EH N
MEN'S	M EH N Z
MEN.	M EH N
MENACING	M EH N AH S IH NG
MENTAL	M EH N T AH L
MENTALITY,	M EH N T AE L AH T IY
MENTIONED	M EH N SH AH N D
MENTIONED)ARE	M EH N CH AH N D AA R
MENTIONED,	M EH N CH AH N D
MENTIONS	M EH N SH AH N Z
MERE	M IH R
MERELY	M IH R L IY
MERYL	M EH R AH L
MESH	M EH SH
MESS.IT'S	M EH S IH T S
MESSAGE	M EH S AH JH
MESSAGE(2)	M EH S IH JH
MESSAGES	M EH S AH JH AH Z
MESSAGES(2)	M EH S IH JH IH Z
MESSAGES,	M EH S IH JH IH Z
MET	M EH T
METAL	M EH T AH L
METAL.	M EH T AH L
METHOD	M EH TH AH D
METICULOUS	M AH T IH K Y AH L AH S
MEXICO	M EH K S AH K OW
MGM	EH M G IY EH M
MICE!	M AY S
MICHAEL	M AY K AH L
MICHELE	M IH SH EH L
MID	M IH D
MIDDLE	M IH D AH L
MIDDLE.	M IH D AH L
MIDDLING	M IH D AH L IH NG
MIDDLING(2)	M IH D L IH NG
MIGHT	M AY T
MILLER	M IH L ER
MILLION	M IH L Y AH N
MILLION,	M IH L Y AH N
MILO	M AY L OW
MIMICKING	M IH M IH K IH NG
MIND	M AY N D
MIND-BOGGLING	M AY N D B AA G AH L IH NG
MINDS	M AY N D Z
MINDS.	M AY N D Z
MINE""	M AY N
MINELLI	M IH N EH L IY
MINUTE	M IH N AH T
MINUTE(2)	M AY N UW T
MINUTE(3)	M AY N Y UW T
MINUTES	M IH N AH T S
MINUTES,	M IH N AH T S
MIRACLE	M IH R AH K AH L
MIRROR,	M IH R ER
MISE	M IH S
MISERY	M IH Z ER IY
MISINFORMATION,	M IH S IH N F ER M EY SH AH N
MISLEADING	M IH S L IY D IH NG
MISLEADING,	M IH S L IY D IH NG
MISS	M IH S
MISS.STARTING	M IH S T AA R T IH NG
MISSED	M IH S T
MISSES	M IH S IH Z
MISSING	M IH S IH NG
MISSION.FOR	M IH SH AH N F AO R
MISTAKE	M IH S T EY K
MISTAKEN	M IH S T EY K AH N
MITCHELL).	M IH CH AH L
MITCHELL.	M IH CH AH L
MIX	M IH K S
MIXED	M IH K S T
MOBILE	M OW B AH L
MOCKUMENTARY	M AA K Y UW M AH N T EH R IY
MODERATELY	M AA D ER AH T L IY
MODERN	M AA D ER N
MOGULS	M OW G AH L Z
MOLLY	M AA L IY
MOMENT	M OW M AH N T
MOMENT,	M OW M AH N T
MOMENTS	M OW M AH N T S
MOMENTS,	M OW M AH N T S
MOMENTS.",7,POS	EH M OW EH M IY EH N T IY EH S EH V AH N P IY OW EH S
MOMENTS.THEIR	M OW M AH N T S DH EH R
MONEY	M AH N IY
MONEY),	M AH N IY
MONEY,	M AH N IY
MONEY.	M AH N IY
MONGER	M AH NG G ER
MONO	M OW N OW
MONTAGE	M AA N T AA ZH
MONTHS,	M AH N TH S
MONTREAL	M AH N T R IY AO L
MONUMENTAL	M AA N Y AH M EH N T AH L
MONUMENTAL(2)	M AA N Y AH M EH N AH L
MONUMENTAL(3)	M AA N Y UW M EH N T AH L
MOON.	M UW N
MOONWALKER	M UW N W AO K ER
MOPE	M OW P
MORAL	M AO R AH L
MORANT"".	M AO R AH N T
MORBID	M AO R B AH D
MORE	M AO R
MORE.	M OW R
MORE.",7,POS	EH M OW AA R IY S EH V AH N P IY OW EH S
MORES	M AO R EY Z
MORES(2)	M AO R IY Z
MORNING,	M AO R N IH NG
MOSQUE	M AA S K
MOSQUE(2)	M AO S K
MOST	M OW S T
MOST(2)	M OW S
MOSTLY	M OW S T L IY
MOSTLY(2)	M OW S L IY
MOTHER,	M AH DH ER
MOTIFS	M OW T IY F S
MOTION	M OW SH AH N
MOUSE	M AW S
MOUSE'.	M AW S AH
MOVE	M UW V
MOVEMENT	M UW V M AH N T
MOVES	M UW V Z
MOVIE	M UW V IY
MOVIE!	M UW V IY
MOVIE!!!!!	M UW V IY
MOVIE!",10,POS	EH M OW V IY AY IY W AH N Z IY R OW P IY OW EH S
MOVIE",10,POS	EH M OW V IY AY IY W AH N Z IY R OW P IY OW EH S
MOVIE'S	M UW V IY Z
MOVIE).	M UW V IY
MOVIE,	M UW V IY
MOVIE.	M UW V IY
MOVIE.",10,POS	EH M OW V IY AY IY W AH N Z IY R OW P IY OW EH S
MOVIE.",7,POS	EH M OW V IY AY IY S EH V AH N P IY OW EH S
MOVIE...I	M UW V IY AY
MOVIE.8/10",8,POS	EH M OW V IY AY IY EY T W AH N Z IY R OW EY T P IY OW EH S
MOVIE.IF	M UW V IY IH F
MOVIE.TO	M UW V IY T UW
MOVIE:	M UW V IY
MOVIES	M UW V IY Z
MOVIES,	M UW V IY Z
MOVIES.	M UW V IY Z
MOVIES.THE	M UW V IY Z DH AH
MOVING	M UW V IH NG
MR	M IH S T ER
MR.	M IH S T ER
MR.TOM	M R T AA M
MS	M IH Z
MS,	EH M EH S
MS.	M IH Z
MUCH	M AH CH
MUCH.",7,POS	EH M Y UW S IY EY CH S EH V AH N P IY OW EH S
MUDDLED	M AH D AH L D
MULTI-AWARD	M AH L T IY AH W AO R D
MULTI-DIMENSIONAL	M AH L T IY D IH M EH N SH AH N AH L
MULTI-PLANE	M AH L T IY P L EY N
MURDER	M ER D ER
MURDERED	M ER D ER D
MURDEROUS	M ER D ER AH S
MURKY	M ER K IY
MUSIC	M Y UW Z IH K
MUSIC,	M Y UW Z IH K
MUSIC.	M Y UW Z IH K
MUSICAL	M Y UW Z IH K AH L
MUSICAL)	M Y UW Z IH K AH L
MUSICAL.)	M Y UW Z IH K AH L
MUSICALS	M Y UW Z IH K AH L Z
MUSICALS,	M Y UW Z IH K AH L Z
MUSICALS.	M Y UW Z IH K AH L Z
MUSICIANS	M Y UW Z IH SH AH N Z
MUSINGS,	M Y UW Z IH NG Z
MUST	M AH S T
MUST'VE	M AH S T IH V
MUST-SEE	M AH S T S IY
MY	M AY
MYSELF	M AY S EH L F
MYSELF,	M AY S EH L F
MYSTERIOUS	M IH S T IH R IY AH S
MYSTERY	M IH S T ER IY
NAGS	N AE G Z
NAILED	N EY L D
NAIVE	N AY IY V
NAME	N EY M
NAME,	N EY M
NAMED	N EY M D
NAMES	N EY M Z
NANCY	N AE N S IY
NARRATE	N EH R EY T
NARRATIVE	N AE R AH T IH V
NARRATIVE(2)	N EH R AH T IH V
NATHAN	N EY TH AH N
NATION'S	N EY SH AH N Z
NATIVE	N EY T IH V
NATURAL	N AE CH ER AH L
NATURAL(2)	N AE CH R AH L
NATUREIT	N AE T Y AH R IY T
NAVIGATE	N AE V AH G EY T
NEARLY	N IH R L IY
NECKS,	N EH K S
NEED	N IY D
NEED?	N IY D
NEEDLESS)	N IY D L AH S
NEEDS	N IY D Z
NEITHER	N IY DH ER
NEITHER(2)	N AY DH ER
NETWORK?	N EH T W ER K
NEUROTIC	N UH R AA T IH K
NEUTRAL	N UW T R AH L
NEVER	N EH V ER
NEVERTHELESS	N EH V ER DH AH L EH S
NEVERTHELESS,	N EH V ER DH AH L EH S
NEW	N UW
NEW(2)	N Y UW
NEWBIE	N UW B IY
NEWNESS	N UW N AH S
NEWT	N UW T
NEWTYPES	N UW T AY P S
NEXT	N EH K S T
NEXT(2)	N EH K S
NEXT.	N EH K S T
NEXT?THE	N EH K S T DH AH
NICE	N AY S
NICE(2)	N IY S
NICE-LOOKING	N AY S L UH K IH NG
NICKNAME	N IH K N EY M
NIGH.	N AY
NIGHT	N AY T
NIGHT,	N AY T
NIGHTMARE	N AY T M EH R
NIGHTMARE.	N AY T M EH R
NIGHTMARES.THIS	N AY T M EH R Z DH IH S
NIGHTMARISH	N AY T M EH R IH SH
NIGHTS	N AY T S
NIGHTS),	N AY T S
NIKAH	N IH K AH
NIKOLAIDIS	N IH K AH L EY D AH S
NINA	N IY N AH
NINE	N AY N
NO	N OW
NO,	N OW
NOBILITY.	N OW B IH L AH T IY
NOBODY	N OW B AA D IY
NOBODY(2)	N OW B AH D IY
NOD	N AA D
NOIR	N OY R
NOMINATED	N AA M AH N EY T AH D
NONE	N AH N
NONETHELESS	N AH N DH AH L EH S
NONSENSICAL	N AA N S EH N S IH K AH L
NOR	N AO R
NORMAL	N AO R M AH L
NORMALLY	N AO R M AH L IY
NORMALLY(2)	N AO R M L IY
NORTH	N AO R TH
NORTHAM	N AO R TH AH M
NOSE-THUMBING	N OW Z TH AH M IH NG
NOSTALGIA	N AO S T AE L JH AH
NOT	N AA T
NOT,	N AA T
NOT.	N AA T
NOTABLY	N OW T AH B L IY
NOTE	N OW T
NOTED	N OW T AH D
NOTED(2)	N OW T IH D
NOTES,	N OW T S
NOTHING	N AH TH IH NG
NOTHING,	N AH TH IH NG
NOTHING.'---THEN	N AH TH IH NG
NOTICE.THE	N OW T AH S DH AH
NOVEL	N AA V AH L
NOW	N AW
NOW!	N AW
NOW)	N AW
NOW,	N AW
NOW,""	N AW
NOW.	N AW
NUANCE	N UW AA N S
NUDE	N UW D
NUDE.	N UW D
NUDITY.	N UW D AH T IY
NUMBER	N AH M B ER
NUMBER,	N AH M B ER
NUMBERS	N AH M B ER Z
NUMBERS.	N AH M B ER Z
NURSES	N ER S AH Z
NURSES(2)	N ER S IH Z
NWA	N W AA
NWA),	N W AA
NWH.	EH N D AH B AH L Y UW EY CH
O'CLOCK,	AH K L AA K
O'HARA,	AA HH AH R AH
O'LEARY,	AA L IY EH R IY
O'LEARY.",9,POS	OW L EH T AH R EH L IY EY AA R W AY N AY N P IY OW EH S
OBLIGATORY	AH B L IH G AH T AO R IY
OBSESSED	AH B S EH S T
OBSESSION	AH B S EH SH AH N
OBTAIN	AH B T EY N
OBTRUSIVE	AH B T R UW S IH V
OBVIOUS	AA B V IY AH S
OBVIOUSLY	AA B V IY AH S L IY
OBVIOUSLY,	AA B V IY AH S L IY
OCCASIONALLY	AO K EY ZH AH N AH L IY
ODD	AA D
ODD,	AA D
ODDYSEY,	AA D AH Z IY
OF	AH V
OF.	AH V
OFF	AO F
OFF.	AO F
OFFERED	AO F ER D
OFFERS	AO F ER Z
OFFICER	AO F AH S ER
OFFICER(2)	AO F IH S ER
OFFICER,	AO F AH S ER
OFFSIDE	AO F S AY D
OFFSIDE,	AO F S AY D
OFTEN	AO F T AH N
OFTEN(2)	AO F AH N
OFTEN.",8,POS	OW EH F T IY IY EH N EY T P IY OW EH S
OGRE	OW G ER
OH,	OW
OHIO	OW HH AY OW
OK	OW K EY
OLD	OW L D
OLD.	OW L D
OLD.I	OW L D AY
OLDER	OW L D ER
OLDEST	OW L D AH S T
OLIVER	AA L AH V ER
OLIVER(2)	AA L IH V ER
ON	AA N
ON(2)	AO N
ON,	AO N
ONCE	W AH N S
ONE	W AH N
ONE(2)	HH W AH N
ONE"")	W AH N
ONE'S	W AH N Z
ONE,	W AH N
ONE.	W AH N
ONE:	W AH N
ONES	W AH N Z
ONES,	W AH N Z
ONLINE)	AO N L AY N
ONLY	OW N L IY
ONTO	AA N T UW
ONTO(2)	AO N T UW
OOD,	UW D
OOPS,	UW P S
OPEN	OW P AH N
OPENED	OW P AH N D
OPENING	OW P AH N IH NG
OPENLY	OW P AH N L IY
OPINION	AH P IH N Y AH N
OPINION,	AH P IH N Y AH N
OPINION.	AH P IH N Y AH N
OPINION.I	AH P IH N Y AH N AY
OPPOSED	AH P OW Z D
OPPOSES.SURE,	AH P OW Z IH Z SH UH R
OPPOSING	AH P OW Z IH NG
OPPOSITE	AA P AH Z IH T
OPPRESSIVE	AH P R EH S IH V
OPTIMISM	AA P T AH M IH Z AH M
OPTIMISM,	AA P T AH M IH Z AH M
OPULENT	AA P Y AH L AH N T
OR	AO R
OR(2)	ER
ORCHESTRAL	AO R K EH S T R AH L
ORDER	AO R D ER
ORDER,	AO R D ER
OREGON	AO R AH G AH N
OREGON(2)	AO R AH G AA N
OREGON,	AO R AH G AH N
OREGONIAN	AO R AH G OW N IY AH N
ORGANIZED	AO R G AH N AY Z D
ORIENTED	AO R IY EH N T AH D
ORIENTED(2)	AO R IY EH N T IH D
ORIGINAL	ER IH JH AH N AH L
ORIGINAL!	AH R IH JH AH N AH L
ORIGINAL.	AH R IH JH AH N AH L
ORIGINAL...THE	AH R IH JH AH N AH L DH AH
ORIGINALITY.",10,POS	OW AA R AY JH IY AY EH N EY EH L AY T IY W AY W AH N Z IY R OW P IY OW EH S
ORIGINALLY	ER IH JH AH N AH L IY
ORIGINALLY(2)	ER IH JH N AH L IY
ORIGINS.	AO R AH JH AH N Z
ORPHANS	AO R F AH N Z
ORSON	AO R S AH N
OSCAR	AO S K ER
OSCAR,	AA S K AA R
OSCARS.SINCE	AA S K AA R Z S IH N S
OTHER	AH DH ER
OTHER,	AH DH ER
OTHER.	AH DH ER
OTHER?)	AH DH ER
OTHERS	AH DH ER Z
OTHERS)--AND	AH DH ER Z
OTHERWISE	AH DH ER W AY Z
OUR	AW ER
OUR(2)	AW R
OUR(3)	AA R
OURSELVES	AW ER S EH L V Z
OURSELVES(2)	AA R S EH L V Z
OUT	AW T
OUT,	AW T
OUT.	AW T
OUT.",7,POS	OW Y UW T IY S EH V AH N P IY OW EH S
OUTCOME	AW T K AH M
OUTSIDE	AW T S AY D
OUTSIDER	AW T S AY D ER
OUTSIDERS	AW T S AY D ER Z
OUTSTANDING	AW T S T AE N D IH NG
OUTSTANDING,	AW T S T AE N D IH NG
OVER	OW V ER
OVER-RATED!	OW V ER R EY T IH D
OVER-RELIANCE	OW V ER R IH L AY AH N S
OVER.	OW V ER
OVERALL	OW V ER AO L
OVERALL,	OW V ER AO L
OVERALL.",10,POS	OW V IY IY AA R EY EH L EH L W AH N Z IY R OW P IY OW EH S
OVERCOME	OW V ER K AH M
OVERDONE.A	OW V ER D AH N AH
OVERSHADOWED	OW V ER SH AE D OW D
OVERWEIGHT	OW V ER W EY T
OVERWHELMING	OW V ER W EH L M IH NG
OVERWHELMING(2)	OW V ER HH W EH L M IH NG
OWN	OW N
OWNER	OW N ER
OXFORD.	AA K S F ER D
P.T.	P IY T IY
PACE	P EY S
PACED.	P EY S T
PACING	P EY S IH NG
PACING:	P EY S IH NG
PACKAGE...HE	P AE S IH JH HH IY
PACKED	P AE K T
PAGE,	P EY JH
PAID	P EY D
PAIN	P EY N
PAINTED	P EY N T AH D
PAINTED(2)	P EY N T IH D
PAINTED(3)	P EY N AH D
PAINTED(4)	P EY N IH D
PAINTERS	P EY N T ER Z
PAINTERS(2)	P EY N ER Z
PAINTERS.I	P EY N T ER Z AY
PAINTING	P EY N T IH NG
PAINTING(2)	P EY N IH NG
PAINTS	P EY N T S
PAJAMA'S	P AH JH AA M AH Z
PAL	P AE L
PAL--HE	P AE L
PALE	P EY L
PALETTE,	P AE L AH T
PALPABLE	P AE L P AH B AH L
PALSY.	P AO L Z IY
PALTROW	P AE L T R OW
PANAHI	P AE N AH HH IY
PANAHI,	P AE N AH HH IY
PANNED	P AE N D
PAOLO	P AW L OW
PAPAL	P EY P AH L
PARAPHRASING	P EH R AH F R EY Z IH NG
PARENT/GRANDPARENT.	P AE R AH N T G R AE N D P AE R AH N T
PARENTS	P EH R AH N T S
PARIS	P EH R IH S
PARIS(2)	P AE R IH S
PARKER	P AA R K ER
PARODY	P EH R AH D IY
PART	P AA R T
PART,	P AA R T
PART.	P AA R T
PART.GENE'S	P AA R T JH IY N Z
PARTIAL	P AA R SH AH L
PARTIALLY	P AA R SH AH L IY
PARTIALLY(2)	P AA R SH L IY
PARTICULAR,	P AA R T IH K Y AH L ER
PARTICULARLY	P AA R T IH K Y AH L ER L IY
PARTICULARLY(2)	P ER T IH K Y AH L ER L IY
PARTLY	P AA R T L IY
PARTNER	P AA R T N ER
PARTNER.	P AA R T N ER
PARTS	P AA R T S
PARTY	P AA R T IY
PARTY'S	P AA R T IY Z
PASDAR	P AE Z D AH R
PASSAGE	P AE S AH JH
PASSAGE(2)	P AE S IH JH
PASSED	P AE S T
PASSES	P AE S AH Z
PASSES(2)	P AE S IH Z
PASSING.	P AE S IH NG
PASSION	P AE SH AH N
PASSIONATE	P AE SH AH N AH T
PAST	P AE S T
PAST.	P AE S T
PATHAR.	P AE TH ER
PATIENT	P EY SH AH N T
PATRICK	P AE T R IH K
PATRICK.	P AE T R AH K
PATRIOTS,	P EY T R IY AH T S
PAY	P EY
PAYING	P EY IH NG
PAYS	P EY Z
PD	P IY D
PEACE	P IY S
PEANUTS),	P IY N AH T S
PECULIAR,	P IH K Y UW L Y ER
PEDIGREE	P EH D AH G R IY
PEEK	P IY K
PENNED	P EH N D
PEOPLE	P IY P AH L
PEOPLE,	P IY P AH L
PEOPLE.	P IY P AH L
PEOPLE?	P IY P AH L
PEOPLES	P IY P AH L Z
PERCEIVE	P ER S IY V
PERCENT	P ER S EH N T
PERFECT	P ER F EH K T
PERFECT(2)	P ER F IH K T
PERFECT.	P ER F AH K T
PERFECTED	P ER F EH K T AH D
PERFECTLY	P ER F AH K T L IY
PERFECTLY(2)	P ER F AH K L IY
PERFORMANCE	P ER F AO R M AH N S
PERFORMANCE,	P ER F AO R M AH N S
PERFORMANCES	P ER F AO R M AH N S AH Z
PERFORMANCES(2)	P ER F AO R M AH N S IH Z
PERFORMANCES,	P ER F AO R M AH N S IH Z
PERFORMANCES.	P ER F AO R M AH N S IH Z
PERFORMANCES.THE	P ER F AO R M AH N S IH Z DH AH
PERFORMANCES??	P ER F AO R M AH N S IH Z
PERHAPS	P ER HH AE P S
PERIOD	P IH R IY AH D
PERIOD!!!	P IH R IY AH D
PERIOD.	P IH R IY AH D
PERMANENT	P ER M AA N EH N T
PERSON	P ER S AH N
PERSONA	P ER S OW N AH
PERSONAL	P ER S IH N AH L
PERSONALITY	P ER S AH N AE L IH T IY
PERSONALLY	P ER S AH N AH L IY
PERSONS	P ER S AH N Z
PERSPECTIVE	P ER S P EH K T IH V
PET	P EH T
PETTIT,	P EH T IH T
PHENOMENAL	F AH N AA M AH N AH L
PHILLIP	F IH L IH P
PHILOSOPHICAL	F IH L AH S AA F IH K AH L
PHILOSOPHICAL.	F IH L AH S AA F IH K AH L
PHOENIX'S	F IY N IH K S IH Z
PHOOL	F UW L
PHOTOGRAPHED	F OW T AH G R AE F T
PHOTOGRAPHY,	F AH T AA G R AH F IY
PIANIST	P IY AE N AH S T
PIANIST(2)	P IY AA N AH S T
PIANIST(3)	P IY AH N IH S T
PICKFORD	P IH K F ER D
PICKFORD--ALWAYS	P IH K F ER D
PICTURE	P IH K CH ER
PICTURE!",9,POS	P IY AY S IY T IY Y UW AA R IY N AY N P IY OW EH S
PICTURE.	P IH K CH ER
PILOT	P AY L AH T
PIPE	P AY P
PIT	P IH T
PIT,	P IH T
PITA	P IY T AH
PITCH	P IH CH
PLACE	P L EY S
PLACE!	P L EY S
PLACE""	P L EY S
PLACE,	P L EY S
PLACE.	P L EY S
PLACE.CINDERELLA	P L EY S IH N D AH R EH L AH
PLACE.HOWEVER,	P L EY S HH AW EH V ER
PLACES	P L EY S AH Z
PLACES(2)	P L EY S IH Z
PLACES,	P L EY S IH Z
PLAIN	P L EY N
PLAN	P L AE N
PLANET	P L AE N AH T
PLANET"",	P L AE N AH T
PLANET'S	P L AE N AH T S
PLANNING	P L AE N IH NG
PLANS	P L AE N Z
PLAY	P L EY
PLAYED	P L EY D
PLAYER	P L EY ER
PLAYERS	P L EY ER Z
PLAYING	P L EY IH NG
PLAYS	P L EY Z
PLEAD	P L IY D
PLEASANT	P L EH Z AH N T
PLEASANTLY	P L EH Z AH N T L IY
PLEASE	P L IY Z
PLEASE.	P L IY Z
PLEASING	P L IY Z IH NG
PLEASURE	P L EH ZH ER
PLENTY	P L EH N T IY
PLENTY(2)	P L EH N IY
PLODS	P L AA D Z
PLOT	P L AA T
PLOT,	P L AA T
PLOTS	P L AA T S
PLOTTED	P L AA T AH D
PLOTTED(2)	P L AA T IH D
PLUMP	P L AH M P
PLUS	P L AH S
POCKET.	P AA K AH T
POETIC	P OW EH T IH K
POIGNANT	P OY N Y AH N T
POINT	P OY N T
POINT.	P OY N T
POINTS	P OY N T S
POINTS.	P OY N T S
POISONED	P OY Z AH N D
POLARIZATION	P OW L ER AH Z EY SH AH N
POLARIZATION(2)	P OW L ER IH Z EY SH AH N
POLICE	P AH L IY S
POLITE	P AH L AY T
POLLAK	P AA L AH K
POOR	P UW R
POORLY	P UW R L IY
POP	P AA P
POP'.	P AA P
POPCORN	P AA P K AO R N
POPULAR	P AA P Y AH L ER
POPULAR,	P AA P Y AH L ER
POPULAR?	P AA P Y AH L ER
PORN	P AO R N
PORTRAIT	P AO R T R AH T
PORTRAY	P AO R T R EY
PORTRAYAL	P AO R T R EY AH L
PORTRAYED	P AO R T R EY D
PORTRAYING	P AO R T R EY IH NG
POSEY	P OW Z IY
POSEY'S	P OW Z IY Z
POSEY.	P OW Z IY
POSITION	P AH Z IH SH AH N
POSITIVE	P AA Z AH T IH V
POSSESS	P AH Z EH S
POSSESS,	P AH Z EH S
POSSESSION	P AH Z EH SH AH N
POSSIBILITY,	P AA S AH B IH L AH T IY
POSSIBLE	P AA S AH B AH L
POSSIBLY	P AA S AH B L IY
POST	P OW S T
POST-MODERN	P OW S T M AA D ER N
POSTERS,	P OW S T ER Z
POSTING	P OW S T IH NG
POSTING,	P OW S T IH NG
POTENTIAL	P AH T EH N SH AH L
POWER	P AW ER
POWERFUL,	P AW ER F AH L
PRANKS.",9,POS	P IY AA R EY EH N K EY EH S N AY N P IY OW EH S
PREDECESSOR	P R EH D AH S EH S ER
PREDICT.	P R IH D IH K T
PREDICTABLE	P R IH D IH K T AH B AH L
PREDICTABLE(2)	P R IY D IH K T AH B AH L
PREDICTABLE,	P R IH D IH K T AH B AH L
PREDOMINATELY	P R IH D AA M AH N AH N T L IY
PREFERRED	P R AH F ER D
PREFERRED(2)	P R IH F ER D
PREFERRED(3)	P R IY F ER D
PREGNANT.	P R EH G N AH N T
PREGNANT.EVENTUALLY	P R EH G N AH N T IH V EH N CH AH W AH L IY
PREMIERE,	P R IH M IH ER
PREPARING	P R IY P EH R IH NG
PREPARING(2)	P ER P EH R IH NG
PRESENCE	P R EH Z AH N S
PRESENT	P R EH Z AH N T
PRESENT(2)	P R IY Z EH N T
PRESENT(3)	P ER Z EH N T
PRESENTATION	P R EH Z AH N T EY SH AH N
PRESENTED	P R IY Z EH N T AH D
PRESENTED(2)	P ER Z EH N T AH D
PRESENTED(3)	P R IY Z EH N AH D
PRESENTED(4)	P ER Z EH N AH D
PRESENTLY	P R EH Z AH N T L IY
PRESENTS	P R EH Z AH N T S
PRESENTS(2)	P R IY Z EH N T S
PRESERVED.	P R IH Z ER V D
PRESSURE,	P R EH SH ER
PRESSURE.	P R EH SH ER
PRESTIGIOUS	P R EH S T IH JH AH S
PRESTIGIOUS(2)	P ER S T IY JH AH S
PRETENDING.	P R IY T EH N D IH NG
PRETENSIONS	P R AH T EH N SH AH N Z
PRETENTIOUS,	P R IH T EH N CH AH S
PRETTY	P R IH T IY
PREVENT	P R IH V EH N T
PREVENT(2)	P R IY V EH N T
PREY	P R EY
PRICE	P R AY S
PRIMARILY	P R AY M EH R AH L IY
PRINCE--LEFT	P R IH N S
PRINCIPAL	P R IH N S AH P AH L
PRINCIPLE	P R IH N S AH P AH L
PRIOR	P R AY ER
PRISONERS	P R IH Z AH N ER Z
PRISONERS(2)	P R IH Z N ER Z
PRIZE	P R AY Z
PRO	P R OW
PRO-GOVERNMENT	P R OW G AH V ER N M AH N T
PROBABLY	P R AA B AH B L IY
PROBLEM	P R AA B L AH M
PROBLEMS	P R AA B L AH M Z
PROBLEMS,	P R AA B L AH M Z
PROCESS	P R AA S EH S
PROCESS(2)	P R AO S EH S
PROCESS.	P R AA S EH S
PRODUCED.	P R AH D UW S T
PRODUCERS	P R AH D UW S ER Z
PRODUCERS)	P R AH D UW S ER Z
PRODUCERS.	P R AH D UW S ER Z
PRODUCING,	P R AH D UW S IH NG
PRODUCT.	P R AA D AH K T
PRODUCTION	P R AH D AH K SH AH N
PRODUCTION(2)	P R OW D AH K SH AH N
PRODUCTION(3)	P ER D AH K SH AH N
PRODUCTIONS.	P R AA D AH K SH AH N Z
PROFESSIONAL.	P R AH F EH SH AH N AH L
PROGRESSES	P R AA G R EH S AH Z
PROGRESSES(2)	P R OW G R EH S AH Z
PROJECTS	P R AA JH EH K T S
PROMISED.	P R AA M AH S T
PROMO	P R OW M OW
PROPER	P R AA P ER
PROSECUTOR	P R AA S IH K Y UW T ER
PROSTHESIS	P R AO S TH EH S IH S
PROSTHESIS(2)	P R AO S TH IY S IH S
PROUSALIS	P R OW Y UW S AH L IY Z
PROVE	P R UW V
PROVIDE	P R AH V AY D
PROVIDES	P R AH V AY D Z
PROVOKE	P R AH V OW K
PSYCHEDELIC-STYLE	S AY K AH D EH L IH K S T AY L
PSYCHOLOGICAL	S AY K AH L AA JH IH K AH L
PUBLIC	P AH B L IH K
PUFNSTUF,	P AH F N S T AH F
PUKE	P Y UW K
PULASKY.	P Y UW L AE S IY
PULL	P UH L
PULLED	P UH L D
PULLING	P UH L IH NG
PULLS	P UH L Z
PUNCH	P AH N CH
PUNCHING	P AH N CH IH NG
PUNCTUATES	P AH NG K CH AH W AH T S
PURCHASE	P ER CH AH S
PURCHASING	P ER CH AH S IH NG
PURE	P Y UH R
PURSUIT	P ER S UW T
PUSHING	P UH SH IH NG
PUT	P UH T
PUTTING	P AH T IH NG
PUTTING(2)	P UH T IH NG
QUALIFYING	K W AA L AH F AY IH NG
QUALITY	K W AA L AH T IY
QUARTER	K W AO R T ER
QUEEN	K W IY N
QUEST,	K W EH S T
QUESTION	K W EH S CH AH N
QUESTION(2)	K W EH SH AH N
QUESTION,	K W EH S CH AH N
QUESTION.	K W EH S CH AH N
QUICK	K W IH K
QUICKLY,	K W IH K L IY
QUIET	K W AY AH T
QUIET,	K W AY AH T
QUIRKY	K W ER K IY
QUIRKY,	K W ER K IY
QUIT	K W IH T
QUITE	K W AY T
R	AA R
R&B	AA R B
R.	AA R
RACE	R EY S
RACE.	R EY S
RACIST,	R EY S IH S T
RACK	R AE K
RADHA	R AA D AH
RADIO	R EY D IY OW
RAID,	R EY D
RAIN	R EY N
RAIN""	R EY N
RAINY	R EY N IY
RAJ	R AA ZH
RAJ(2)	R AA JH
RALPH	R AE L F
RAMONES	R AH M OW N Z
RAMONES,	R AH M OW N Z
RAMONES?	R AH M OW N Z
RAMOS	R AA M OW S
RAMOS(2)	R EY M OW S
RAN	R AE N
RANDOLPH	R AE N D AA L F
RANDOM	R AE N D AH M
RANGE	R EY N JH
RAP	R AE P
RAP,	R AE P
RAPPERS	R AE P ER Z
RARE	R EH R
RARELY	R EH R L IY
RATE	R EY T
RATED	R EY T AH D
RATED(2)	R EY T IH D
RATHER	R AE DH ER
RATHER(2)	R AH DH ER
RATHER,	R AE DH ER
RATING	R EY T IH NG
RATING),	R EY T IH NG
RATINGS	R EY T IH NG Z
RATINGS---FOR	R EY T IH NG Z
RAVES	R EY V Z
RAWKED	R AO K T
RAY	R EY
RAYBURN	R EY B ER N
RAYMOND	R EY M AH N D
REACHED	R IY CH T
REACHES	R IY CH AH Z
REACHES(2)	R IY CH IH Z
READ	R EH D
READ(2)	R IY D
READY	R EH D IY
REAL	R IY L
REAL""	R IY L
REAL,	R IY L
REAL-LIFE	R IY L L AY F
REAL.	R IY L
REAL...	R IY L
REALISES	R IY AH L AY Z IH Z
REALISTIC	R IY AH L IH S T IH K
REALISTIC...IT'S	R IY AH L IH S T IH K IH T S
REALITIES	R IY AE L AH T IY Z
REALITY	R IY AE L AH T IY
REALIZE	R IY AH L AY Z
REALIZE.	R IY L AY Z
REALIZED	R IY AH L AY Z D
REALIZES	R IY AH L AY Z IH Z
REALIZING	R IY AH L AY Z IH NG
REALLY	R IH L IY
REALLY(2)	R IY L IY
REALLY,	R IY L IY
REALLY.	R IY L IY
REALM	R EH L M
REASON	R IY Z AH N
REASON.	R IY Z AH N
REASONS,	R IY Z AH N Z
REAY	R EY
REBECCA	R AH B EH K AH
REBIRTH	R IY B ER TH
RECEIVED	R AH S IY V D
RECEIVED(2)	R IH S IY V D
RECEIVED(3)	R IY S IY V D
RECENT	R IY S AH N T
RECENTLY	R IY S AH N T L IY
RECENTLY(2)	R IY S AH N L IY
RECIPE	R EH S AH P IY
RECOGNISE	R EH K AH G N AY Z
RECOGNIZED	R EH K AH G N AY Z D
RECOMMEND	R EH K AH M EH N D
RECOMMEND.",8,POS	AA R IY S IY OW EH M EH M IY EH N D IY EY T P IY OW EH S
RECOMMENDABLE	R EH K AH M EH N D AH B AH L
RECOMMENDATION	R EH K AH M AH N D EY SH AH N
RECOMMENDED.8/10",8,POS	AA R IY S IY OW EH M EH M IY EH N D IY IY D IY EY T W AH N Z IY R OW EY T P IY OW EH S
RECOMMENDING	R EH K AH M EH N D IH NG
RECORD	R AH K AO R D
RECORD(2)	R EH K ER D
RECORD(3)	R IH K AO R D
RECORDING	R AH K AO R D IH NG
RECORDING(2)	R IH K AO R D IH NG
RECOVER	R IH K AH V ER
RECOVERED	R AH K AH V ER D
RECOVERED(2)	R IH K AH V ER D
RECOVERED.	R IH K AH V ER D
RECYCLED	R IY S AY K AH L D
RED	R EH D
REED,	R IY D
REFRESHING	R IH F R EH SH IH NG
REFUSE	R AH F Y UW Z
REFUSE(2)	R EH F Y UW Z
REFUSE(3)	R IH F Y UW Z
REFUSES	R AH F Y UW Z AH Z
REFUSES(2)	R IH F Y UW Z IH Z
REGARDED	R AH G AA R D AH D
REGARDED(2)	R IH G AA R D IH D
REGARDING	R AH G AA R D IH NG
REGARDING(2)	R IH G AA R D IH NG
REHASH	R IY HH AE SH
REHEARSING	R IH HH ER S IH NG
REJECTED	R IH JH EH K T IH D
REJECTED(2)	R IY JH EH K T AH D
REJECTED(3)	R IY JH EH K T IH D
RELATE	R IH L EY T
RELATE(2)	R IY L EY T
RELATIONSHIP,	R IY L EY SH AH N SH IH P
RELATIONSHIPS	R IY L EY SH AH N SH IH P S
RELATIVELY	R EH L AH T IH V L IY
RELEASE	R IY L IY S
RELEASE),	R IY L IY S
RELEASE,	R IY L IY S
RELEASED	R IY L IY S T
RELEASES,	R IY L IY S IH Z
RELENTLESS	R IH L EH N T L IH S
RELIED	R IH L AY D
RELIED(2)	R IY L AY D
RELIGIOUS/CONSERVATIVE	R IH L IH JH AH S K AH N S ER V AH T IH V
RELISH	R EH L IH SH
REMAINS	R IH M EY N Z
REMAINS(2)	R IY M EY N Z
REMAINS---'SAD	R IH M EY N Z
REMAKE	R IY M EY K
REMARKABLE	R IH M AA R K AH B AH L
REMARKABLE(2)	R IY M AA R K AH B AH L
REMARKABLE.MY	R IH M AA R K AH B AH L M AY
REMEMBER	R IH M EH M B ER
REMEMBER(2)	R IY M EH M B ER
REMEMBER,	R IH M EH M B ER
REMEMBERED	R IH M EH M B ER D
REMEMBERED(2)	R IY M EH M B ER D
REMIND	R IY M AY N D
REMINDED	R IY M AY N D AH D
REMINDED(2)	R IY M AY N D IH D
REMINDS	R IY M AY N D Z
REMINISCENT	R EH M AH N IH S AH N T
RENAISSANCE	R EH N AH S AA N S
RENDITION	R EH N D IH SH AH N
RENO	R IY N OW
RENOWN,	R IH N AW N
RENT	R EH N T
RENTAL	R EH N T AH L
REPEAT	R IH P IY T
REPEAT(2)	R IY P IY T
REPEATED	R IH P IY T IH D
REPEATED(2)	R IY P IY T AH D
REPEATED(3)	R IY P IY T IH D
REPEATING	R IH P IY T IH NG
REPEATING(2)	R IY P IY T IH NG
REPEATS	R IH P IY T S
REPEATS(2)	R IY P IY T S
REPERTORY	R EH P ER T AO R IY
REPLAY	R IY P L EY
REPLIES,	R IH P L AY Z
REPRESENTATION	R EH P R AH Z EH N T EY SH AH N
REPRESSING	R IY P R EH S IH NG
REQUIRED	R IY K W AY ER D
REQUIRED(2)	R IY K W AY R D
RESEARCH	R IY S ER CH
RESEMBLING	R IH Z EH M B AH L IH NG
RESEMBLING(2)	R IY Z EH M B AH L IH NG
RESEMBLING(3)	R IY Z EH M B L IH NG
RESERVATIONS	R EH Z ER V EY SH AH N Z
RESIDENT	R EH Z IH D AH N T
RESORT	R IH Z AO R T
RESORT(2)	R IY Z AO R T
RESORT(3)	R IY S AO R T
RESPECTFULLY	R IH S P EH K T F AH L IY
RESPECTS,	R IH S P EH K T S
RESPONSE	R IH S P AA N S
RESPONSE(2)	R IY S P AA N S
RESPONSIBLE	R IY S P AA N S AH B AH L
RESSE	R IH S IY
REST	R EH S T
RESTART	R IY S T AA R T
RESTRAIN	R IY S T R EY N
RESTS	R EH S T S
RESULT	R IH Z AH L T
RESULT(2)	R IY Z AH L T
RESURRECT	R EH Z ER EH K T
RETAINING	R IH T EY N IH NG
RETAINING(2)	R IY T EY N IH NG
RETAKES	R IY T EY K S
RETICENT	R EH T IH S AH N T
RETIRED	R IH T AY R D
RETIRED(2)	R IY T AY ER D
RETIRED(3)	R IY T AY R D
RETIREMENT	R IY T AY ER M AH N T
RETIREMENT(2)	R IH T AY ER M AH N T
RETREAT.	R IY T R IY T
RETROSPECT	R EH T R AH S P EH K T
RETURN	R IH T ER N
RETURN(2)	R IY T ER N
RETURNS	R IH T ER N Z
RETURNS(2)	R IY T ER N Z
REVEALING	R IH V IY L IH NG
REVEALING(2)	R IY V IY L IH NG
REVELATIONS,	R EH V AH L EY SH AH N Z
REVENGE"")",10,POS	AA R IY V IY IY EH N JH IY IY W AH N Z IY R OW P IY OW EH S
REVIEWERS	R IY V Y UW ER Z
REVIVING	R IH V AY V IH NG
REVIVING(2)	R IY V AY V IH NG
REVOLVING	R IY V AA L V IH NG
REYNOLDS);	R IY Y N OW L D Z
RHYTHM""	R IH DH AH M
RIBBONS.	R IH B AH N Z
RICCI,	R IH K S IY
RICH	R IH CH
RICHARDSON'S	R IH CH ER D S AH N Z
RID	R IH D
RIDDLED	R IH D AH L D
RIDE	R AY D
RIDE....HOORAY!!!!,8,POS	AA R AY D IY IY EY CH OW OW AA R EY W AY EY T P IY OW EH S
RIDICULOUS	R IH D IH K Y AH L AH S
RIDICULOUS,	R AH D IH K Y AH L AH S
RIDICULOUS.	R AH D IH K Y AH L AH S
RIGHT	R AY T
RIGHT,	R AY T
RIGHT.	R AY T
RIGHT.",7,POS	AA R AY JH IY EY CH T IY S EH V AH N P IY OW EH S
RINGWALD	R IH NG W AO L D
RISK	R IH S K
RITA	R IY T AH
RITTER	R IH T ER
RIVAL	R AY V AH L
RIVAL,	R AY V AH L
RIVER	R IH V ER
RIVERSIDE	R IH V ER S AY D
ROAMING	R OW M IH NG
ROBERT	R AA B ER T
ROBINSON)	R AA B AH N S AH N
ROCK	R AA K
ROCK'N'ROLL	R AA K AH N R OW L
ROCK,	R AA K
ROCKETS---GIVE	R AA K AH T S
ROCKS	R AA K S
ROCKY	R AA K IY
ROGER	R AA JH ER
ROGERS.	R AA JH ER Z
ROLE	R OW L
ROLE,	R OW L
ROLE---ALL	R OW L
ROLE.	R OW L
ROLES	R OW L Z
ROLL	R OW L
ROMANCE	R OW M AE N S
ROMANCE.	R OW M AE N S
ROMANTIC	R OW M AE N T IH K
ROMANTICS	R OW M AE N T IH K S
ROMEO	R OW M IY OW
ROOKIE	R UH K IY
ROOTLESS	R UW T L AH S
ROPE	R OW P
ROSE	R OW Z
ROSEANNE	R OW Z AE N
ROUGHLY	R AH F L IY
ROUND,	R AW N D
ROUTINES.THE	R UW T IY N Z DH AH
RULED.	R UW L D
RULES	R UW L Z
RULES.GIVEN	R UW L Z G IH V AH N
RUNNER'---ANYTHING	R AH N ER
RUNNING	R AH N IH NG
RUNS	R AH N Z
RUSSELL	R AH S AH L
RUSSELL)	R AH S AH L
RUSSIAN	R AH SH AH N
SACRIFICE	S AE K R AH F AY S
SACRIFICE...MEANWHILE,	S AE K R AH F AY S M IY N W AY L
SAD	S AE D
SAD,	S AE D
SAD.	S AE D
SADDEST	S AE D AH S T
SADLY	S AE D L IY
SADLY,	S AE D L IY
SAFE	S EY F
SAFE.	S EY F
SAGA)	S AA G AH
SAHIB	S AE HH AH B
SAID	S EH D
SAID,	S EH D
SAILOR	S EY L ER
SAILOR,	S EY L ER
SALESMAN	S EY L Z M AH N
SAM	S AE M
SAME	S EY M
SAME,	S EY M
SAMUEL	S AE M Y UW L
SANDLER	S AE N D L ER
SANT	S AE N T
SAT	S AE T
SATAN"",	S EY T AH N
SATAN.	S EY T AH N
SATANIC	S AH T AE N IH K
SATIN.	S AE T AH N
SATIRE	S AE T AY ER
SATISFY	S AE T AH S F AY
SATISFY(2)	S AE T IH S F AY
SATISFYING	S AE T IH S F AY IH NG
SAVED	S EY V D
SAW	S AO
SAW.	S AO
SAY	S EY
SAY,	S EY
SAY?	S EY
SAYING	S EY IH NG
SAYING,	S EY IH NG
SAYING.	S EY IH NG
SAYS	S EH Z
SAYS(2)	S IH Z
SCALE	S K EY L
SCARES	S K EH R Z
SCARIEST	S K EH R IY AH S T
SCARY,	S K EH R IY
SCENARIO	S IH N EH R IY OW
SCENARIOS	S IH N EH R IY OW Z
SCENE	S IY N
SCENE,	S IY N
SCENE.ITS	S IY N IH T S
SCENERY.	S IY N AH R IY
SCENES	S IY N Z
SCENES)	S IY N Z
SCENES.	S IY N Z
SCENES",8,POS	EH S IY IY EH N IY EH S EY T P IY OW EH S
SCHEDULE	S K EH JH UH L
SCHEDULE(2)	S K EH JH UW L
SCHEDULE,	S K EH JH UW L
SCHERLER	S K AH R L AH R
SCHLOCKY	S K L AA K IY
SCHOOL	S K UW L
SCHOOL'S	S K UW L Z
SCHOOL)IT	S K UW L IH T
SCHOOLS	S K UW L Z
SCI-FI	S AY F AY
SCOOP.	S K UW P
SCOPE	S K OW P
SCORE	S K AO R
SCORE.OR	S K OW R AO R
SCORSESE	S K AO R S IY Z
SCORSESE(2)	S K AO R S EY Z IY
SCORSESE.	S K AO R S IY Z
SCOTT	S K AA T
SCRATCHING	S K R AE CH IH NG
SCREEN	S K R IY N
SCREEN,	S K R IY N
SCREEN.	S K R IY N
SCREEN.FORTUNATELY,	S K R IY N F AO R CH AH N AH T L IY
SCREEN.PAKEEZAH	S K R IY N P EY K IY Z AH
SCREENPLAY	S K R IY N P L EY
SCREWING	S K R UW IH NG
SCRIPT	S K R IH P T
SCRIPT,	S K R IH P T
SEA	S IY
SEAN	SH AO N
SEARCHING	S ER CH IH NG
SEASON	S IY Z AH N
SEAT	S IY T
SECOND	S EH K AH N D
SECONDARY	S EH K AH N D EH R IY
SECRET	S IY K R AH T
SECRET(2)	S IY K R IH T
SECRET.	S IY K R AH T
SECRETLY	S IY K R IH T L IY
SEE	S IY
SEE,	S IY
SEE.AN	S IY AE N
SEEING	S IY IH NG
SEEING.	S IY IH NG
SEEKS	S IY K S
SEEM	S IY M
SEEMED	S IY M D
SEEMINGLY	S IY M IH NG L IY
SEEMS	S IY M Z
SEEN	S IY N
SEEN!	S IY N
SEEN.........	S IY N
SEGMENTS	S EH G M AH N T S
SEGMENTS(2)	S EH G M EH N T S
SELF	S EH L F
SELF-DESTRUCTION	S EH L F D IH S T R AH K T S
SELF-INDULGENT	S EH L F IH N D AH L JH AH N T
SELF-KNOWLEDGE	S EH L F N AA L AH JH
SELL	S EH L
SENDS,	S EH N D Z
SENSE	S EH N S
SENSE.	S EH N S
SENSITIVE	S EH N S AH T IH V
SENSITIVE(2)	S EH N S IH T IH V
SENSITIVELY,	S EH N S AH T IH V L IY
SENT	S EH N T
SENTENCED	S EH N T AH N S T
SEPARATE	S EH P ER EY T
SEPARATE(2)	S EH P ER IH T
SEPARATE(3)	S EH P R AH T
SEPARATED	S EH P ER EY T AH D
SEPARATED(2)	S EH P ER EY T IH D
SEPARATING	S EH P ER EY T IH NG
SEQUELS	S IY K W AH L Z
SEQUENCE	S IY K W AH N S
SEQUENCES	S IY K W AH N S AH Z
SEQUENCES(2)	S IY K W AH N S IH Z
SEQUENCES,	S IY K W AH N S IH Z
SEQUENCES.	S IY K W AH N S IH Z
SERIAL	S IH R IY AH L
SERIES	S IH R IY Z
SERIES,	S IH ER IY Z
SERIES,EVEN	S IH ER IY Z IY V AH N
SERIES.	S IH ER IY Z
SERIOUS	S IH R IY AH S
SERIOUS.	S IH R IY AH S
SERIOUS.MAYBE	S IH R IY AH S M EY B IY
SERIOUSLY	S IH R IY AH S L IY
SERIOUSLY,	S IH R IY AH S L IY
SERIOUSLY.	S IH R IY AH S L IY
SERVED	S ER V D
SERVICEABLE	S ER V AH S AH B AH L
SET	S EH T
SET,	S EH T
SET-PIECE	S EH T P IY S
SET-PIECES	S EH T P IY S AH Z
SETS	S EH T S
SETTING	S EH T IH NG
SETTLES	S EH T AH L Z
SEVENTIES,	S EH V AH N T IY Z
SEVERAL	S EH V ER AH L
SEVERE	S AH V IH R
SEX	S EH K S
SEXUAL	S EH K SH UW AH L
SEXUAL,	S EH K SH AH W AH L
SEXUAL.	S EH K SH AH W AH L
SEXUALLY	S EH K SH UW AH L IY
SEXY	S EH K S IY
SHADES	SH EY D Z
SHADOW	SH AE D OW
SHADOWED	SH AE D OW D
SHADOWS	SH AE D OW Z
SHAKES	SH EY K S
SHAKESPEARE	SH EY K S P IY R
SHAKESPEARE'S	SH EY K S P IY R Z
SHALL	SH AE L
SHALLOW.	SH AE L OW
SHALLOW.",8,POS	EH S EY CH EY EH L EH L OW D AH B AH L Y UW EY T P IY OW EH S
SHAME	SH EY M
SHAME.	SH EY M
SHAMELESSLY	SH EY M L AH S L IY
SHANGHAI	SH AE NG HH AY
SHANGHAI""	SH AE N EY
SHAW	SH AO
SHE	SH IY
SHE'LL	SH IY L
SHE'S	SH IY Z
SHEDS	SH EH D Z
SHEPPARD	SH EH P ER D
SHINE	SH AY N
SHIRLEY	SH ER L IY
SHOCK	SH AA K
SHOE	SH UW
SHOOTING	SH UW T IH NG
SHOOTS	SH UW T S
SHORE	SH AO R
SHORT	SH AO R T
SHORT,	SH AO R T
SHORT.	SH AO R T
SHORTLY	SH AO R T L IY
SHORTS	SH AO R T S
SHOT	SH AA T
SHOT,	SH AA T
SHOT.	SH AA T
SHOTS	SH AA T S
SHOULD	SH UH D
SHOULD.	SH UH D
SHOULDERS	SH OW L D ER Z
SHOULDN'T	SH UH D AH N T
SHOW	SH OW
SHOW,	SH OW
SHOW.	SH OW
SHOW.THE	SH OW DH AH
SHOWED	SH OW D
SHOWING	SH OW IH NG
SHOWN	SH OW N
SHOWS	SH OW Z
SHOWS,	SH OW Z
SHRINK	SH R IH NG K
SHRUG	SH R AH G
SHUTTLE	SH AH T AH L
SICK	S IH K
SIDE	S AY D
SIGHT.	S AY T
SIGNIFICANCE.	S IH G N IH F IH K AH N S
SIGNIFICANT	S AH G N IH F IH K AH N T
SIGNIFICANT(2)	S IH G N IH F IH K AH N T
SIKES,	S AY K S
SILENCE	S AY L AH N S
SILENT	S AY L AH N T
SILLY	S IH L IY
SILLY,	S IH L IY
SIMILAR	S IH M AH L ER
SIMON	S AY M AH N
SIMPLE	S IH M P AH L
SIMPLE,	S IH M P AH L
SIMPLISTIC	S IH M P L IH S T IH K
SIMPLY	S IH M P L IY
SINATRA	S AH N AA T R AH
SINCE	S IH N S
SINCE,	S IH N S
SINCERELY	S IH N S IH R L IY
SING	S IH NG
SINGER	S IH NG ER
SINGING	S IH NG IH NG
SINGING,	S IH NG IH NG
SINGLE	S IH NG G AH L
SINGLE.	S IH NG G AH L
SIR	S ER
SISSY'S	S IH S IY Z
SISTER	S IH S T ER
SISTERS	S IH S T ER Z
SISTERS,	S IH S T ER Z
SIT..........OUT	S IH T AW T
SITCOM	S IH T K AA M
SITCOM.	S IH T AH M
SITCOMS	S IH T K AA M Z
SITTING	S IH T IH NG
SITUATED	S IH CH UW EY T IH D
SITUATION	S IH CH UW EY SH AH N
SITUATIONS	S IH CH UW EY SH AH N Z
SITUATIONS,	S IH CH AH W EY SH AH N Z
SIX	S IH K S
SIX-PENCE.	S IH K S P EH N S
SIXTEEN!	S IH K S T IY N
SIZED	S AY Z D
SKELETON	S K EH L AH T AH N
SKILLS	S K IH L Z
SKY	S K AY
SKY.	S K AY
SKYE	S K AY
SLAPPED	S L AE P T
SLASHER	S L AE SH ER
SLAY	S L EY
SLAYED	S L EY D
SLAYER""	S L EY ER
SLAYING	S L EY IH NG
SLEAZIEST	S L IY Z AY AH S T
SLEEPING	S L IY P IH NG
SLIGHTLY	S L AY T L IY
SLIPPER	S L IH P ER
SLOAN'S	S L OW N Z
SLOAN.	S L OW AH N
SLOANE	S L OW N
SLOW	S L OW
SLOW-PACED	S L OW P EY S T
SLOWLY	S L OW L IY
SMALL	S M AO L
SMALL,	S M AO L
SMALLER	S M AO L ER
SMART	S M AA R T
SMARTEST	S M AA R T AH S T
SMELL	S M EH L
SMILE	S M AY L
SMILE,	S M AY L
SMILING	S M AY L IH NG
SMITH	S M IH TH
SMOKE	S M OW K
SMOOTHLY,	S M UW DH L IY
SNAPPED	S N AE P T
SNAPPING	S N AE P IH NG
SNOW	S N OW
SO	S OW
SO,	S OW
SO.	S OW
SOAVI'S	S OW V AH Z
SOCCER	S AA K ER
SOCIETY	S OW S AY IH T IY
SOCIETY.	S AH S AY AH T IY
SOCIOPATH.	S OW S IY AH P AH TH
SOFT	S AA F T
SOFT(2)	S AO F T
SOME	S AH M
SOMEDAY	S AH M D EY
SOMEHOW	S AH M HH AW
SOMEONE	S AH M W AH N
SOMEONE.",10,POS	EH S OW EH M IY OW EH N IY W AH N Z IY R OW P IY OW EH S
SOMETHING	S AH M TH IH NG
SOMETIMES	S AH M T AY M Z
SOMEWHAT	S AH M W AH T
SOMEWHAT(2)	S AH M HH W AH T
SON	S AH N
SON,	S AH N
SONG	S AO NG
SONGS	S AO NG Z
SONGS,	S AO NG Z
SONGS.	S AO NG Z
SONGS.THE	S AO NG Z DH AH
SOON	S UW N
SOPHY	S OW F IY
SORE,	S OW R
SORROW	S AA R OW
SORRY	S AA R IY
SORT	S AO R T
SORTS	S AO R T S
SORTS,	S AO R T S
SOUL	S OW L
SOUND	S AW N D
SOUNDS	S AW N D Z
SOUNDS(2)	S AW N Z
SOUNDTRACK,	S AW N D T R AE K
SOUR	S AW ER
SOUR(2)	S AW R
SOX	S AA K S
SOX/YANKEE	S AA K S Y AE NG K IY
SPACE	S P EY S
SPACE-FARING,	S P EY S F EH R IH NG
SPACED	S P EY S T
SPADES.	S P EY D Z
SPEAK	S P IY K
SPEAKS	S P IY K S
SPECIAL	S P EH SH AH L
SPECIALTY	S P EH SH AH L T IY
SPECIALTY(2)	S P EY SH AH L T IY
SPECIFIC	S P AH S IH F IH K
SPECIFIC(2)	S P IH S IH F IH K
SPECTACLE	S P EH K T AH K AH L
SPECTACULAR.	S P EH K T AE K Y AH L ER
SPECTACULAR...	S P EH K T AE K Y AH L ER
SPECULATION	S P EH K Y AH L EY SH AH N
SPEECHES	S P IY CH AH Z
SPEECHES(2)	S P IY CH IH Z
SPELL	S P EH L
SPENCER	S P EH N S ER
SPENCER'S	S P EH N S ER Z
SPEND	S P EH N D
SPENT	S P EH N T
SPINE	S P AY N
SPINE-CHILLING	S P AY N CH IH L IH NG
SPOCK	S P AA K
SPOIL	S P OY L
SPOILING	S P OY L IH NG
SPONTANEOUS	S P AA N T EY N IY AH S
SPOOFING	S P UW F IH NG
SPORTS	S P AO R T S
SPORTS,	S P OW R T S
SPOT	S P AA T
SPOTS	S P AA T S
SPOUSE'S	S P AW S IH Z
SPUR	S P ER
ST.	S T R IY T
ST.(2)	S EY N T
STAG'.	S T AE G
STAGE-EY	S T EY JH IY IY
STAGES,	S T EY JH IH Z
STAMMERING,	S T AE M ER IH NG
STANDARD	S T AE N D ER D
STANDARDS	S T AE N D ER D Z
STANDING	S T AE N D IH NG
STANDS	S T AE N D Z
STANWYCK	S T AE N W AH K
STAR	S T AA R
STAR,	S T AA R
STARK	S T AA R K
STARRED	S T AA R D
STARRING	S T AA R IH NG
STARS	S T AA R Z
STARS.	S T AA R Z
START	S T AA R T
STARTED	S T AA R T AH D
STARTED(2)	S T AA R T IH D
STARTS	S T AA R T S
STARTS.	S T AA R T S
STATEMENT	S T EY T M AH N T
STATEMENTS	S T EY T M AH N T S
STATING	S T EY T IH NG
STATION)	S T EY SH AH N
STAVROS	S T AH V R OW Z
STAY	S T EY
STEAL	S T IY L
STEELE).	S T IY L
STEP	S T EH P
STEPHENSON	S T IY V AH N S AH N
STEPSISTERS	S T EH P S IH S T ER Z
STEVEN	S T IY V AH N
STILL	S T IH L
STILL,	S T IH L
STILTED	S T IH L T IH D
STOIC	S T OW IH K
STOMACH	S T AH M AH K
STONER-	S T OW N ER
STOOD	S T UH D
STOOPID	S T UW P AH D
STOP	S T AA P
STORE.	S T OW R
STORIES	S T AO R IY Z
STORIES,	S T OW R IY Z
STORIES.	S T OW R IY Z
STORY	S T AO R IY
STORY)	S T OW R IY
STORY,	S T OW R IY
STORY.	S T OW R IY
STRAIGHTFORWARD...BUT	S T R EY T F AO R W ER D B AH T
STRANDED	S T R AE N D AH D
STRANDED(2)	S T R AE N D IH D
STRANGE	S T R EY N JH
STRANGELY	S T R EY N JH L IY
STREEP	S T R IY P
STREET	S T R IY T
STREET"".	S T R IY T
STREETS,	S T R IY T S
STREETS.	S T R IY T S
STRESS	S T R EH S
STRETCHES	S T R EH CH AH Z
STRETCHES(2)	S T R EH CH IH Z
STRIKES	S T R AY K S
STRONG	S T R AO NG
STRONGLY	S T R AO NG L IY
STRUGGLE	S T R AH G AH L
STRUGGLE.	S T R AH G AH L
STRUGGLING	S T R AH G AH L IH NG
STRUGGLING(2)	S T R AH G L IH NG
STUCK	S T AH K
STUDENT	S T UW D AH N T
STUDENTS	S T UW D AH N T S
STUDIED	S T AH D IY D
STUDIO	S T UW D IY OW
STUDIOS.AS	S T UW D IY OW Z AE Z
STUDY	S T AH D IY
STUDYING	S T AH D IY IH NG
STUDYING.	S T AH D IY IH NG
STUFF	S T AH F
STUFF,	S T AH F
STUFF.	S T AH F
STUNNING	S T AH N IH NG
STUNNING.	S T AH N IH NG
STUNT	S T AH N T
STUPID,	S T UW P AH D
STUPIDLY,	S T UW P AH D L IY
STYLE	S T AY L
STYLED	S T AY L D
STYLES	S T AY L Z
STYLISED	S T AY L IY Z D
STYLISH	S T AY L IH SH
STYLIZATIONS---A	S T AY L AH Z EY SH AH N Z
SUBLIME	S AH B L AY M
SUBLIME,	S AH B L AY M
SUBPLOT	S AH B P L AA T
SUBTITLED	S AH B T AY T AH L D
SUBURBAN	S AH B ER B AH N
SUCCESS	S AH K S EH S
SUCCESS,	S AH K S EH S
SUCCESS;	S AH K S EH S
SUCCESSFUL	S AH K S EH S F AH L
SUCCUMBED	S AH K AH M D
SUCH	S AH CH
SUCH.'	S AH CH
SUCK	S AH K
SUDDENLY	S AH D AH N L IY
SUGGEST	S AH JH EH S T
SUICIDE	S UW AH S AY D
SUICIDE(2)	S UW IH S AY D
SUIT	S UW T
SUITABLE	S UW T AH B AH L
SUITS	S UW T S
SUM	S AH M
SUMMERTIME	S AH M ER T AY M
SUMMING	S AH M IH NG
SUMPTUOUS	S AH M P CH W AH S
SUMPTUOUS(2)	S AH M P CH UW AH S
SUNG	S AH NG
SUNRISE""	S AH N R AY Z
SUPERB	S UH P ER B
SUPERBLY	S UW P ER B L IY
SUPERSTARDOM	S UW P ER S T AA R D AH M
SUPPORT	S AH P AO R T
SUPPORTING	S AH P AO R T IH NG
SUPPOSE).	S AH P OW Z
SUPPOSED	S AH P OW Z D
SUPPOSEDLY	S AH P OW Z AH D L IY
SUPREMELY	S UW P R IY M AH L IY
SURE	SH UH R
SURE,	SH UH R
SURE.	SH UH R
SURELY	SH UH R L IY
SURFACE	S ER F AH S
SURFACE,	S ER F AH S
SURPASSES	S ER P AE S IH Z
SURPRISE,	S ER P R AY Z
SURPRISE,CHARLEY	S ER P R AY Z CH AA R L IY
SURPRISED	S ER P R AY Z D
SURPRISED(2)	S AH P R AY Z D
SURPRISES.	S ER P R AY Z IH Z
SURREAL.	S ER R IY L
SURROUNDED	S ER AW N D AH D
SURROUNDED(2)	S ER AW N D IH D
SUSPECT	S AH S P EH K T
SUSSANAH	S AH S AH N AH
SUZANNE	S UW Z AE N
SUZANNE,	S UW Z AH N
SWEARS	S W EH R Z
SWEATER	S W EH T ER
SWEDEN,	S W IY D AH N
SWEEPS	S W IY P S
SWEET	S W IY T
SWEET,	S W IY T
SWEET.	S W IY T
SWEETHEART.	S W IY T HH AA R T
SWEETLY	S W IY T L IY
SWIFT	S W IH F T
SWIFTLY	S W IH F T L IY
SWING	S W IH NG
SWORD	S AO R D
SWORDPLAY	S AO R D P L EY
SWORDSMAN	S OW R D Z M AE N
SWORDSMANS	S OW R D Z M AE N Z
SYMBOLISM	S IH M B AH L IH Z AH M
SYMPATHETIC	S IH M P AH TH EH T IH K
SYMPATHIZE	S IH M P AH TH AY Z
SYSTEM	S IH S T AH M
SYSTEM.	S IH S T AH M
SYSTEM;	S IH S T AH M
SZWARC,	S Z W AO R K
TABOO	T AE B UW
TACKY	T AE K IY
TAFT	T AE F T
TAKAISHVILI,DODO	T AH K EY SH V AH L IY D UW D UW
TAKE	T EY K
TAKEN	T EY K AH N
TAKES	T EY K S
TAKES---THIS	T EY K S
TAKING	T EY K IH NG
TAKITA	T AE K AH T AH
TALE	T EY L
TALE,	T EY L
TALENT	T AE L AH N T
TALENTED	T AE L AH N T AH D
TALENTED(2)	T AE L AH N T IH D
TALK	T AO K
TALKING	T AO K IH NG
TALKS.",10,POS	T IY EY EH L K EY EH S W AH N Z IY R OW P IY OW EH S
TARGET,	T AA R G AH T
TARGETED	T AA R G AH T IH D
TASK	T AE S K
TASTELESS	T EY S T L AH S
TEACHES	T IY CH AH Z
TEACHES(2)	T IY CH IH Z
TEAM	T IY M
TEAM.	T IY M
TEAMS	T IY M Z
TEAMWORK	T IY M W ER K
TEAR	T EH R
TEAR(2)	T IH R
TEARS	T EH R Z
TEARS(2)	T IH R Z
TEDIOUS	T IY D IY AH S
TEDIOUS.HIGHLY	T IY D IY AH S HH AY L IY
TEDIUM	T IY D IY AH M
TEEN	T IY N
TEENAGE	T IY N EY JH
TEENAGER	T IY N EY JH ER
TEENAGERS	T IY N EY JH ER Z
TEENS	T IY N Z
TELESCOPE.	T EH L AH S K OW P
TELEVISION	T EH L AH V IH ZH AH N
TELL	T EH L
TELL.BUT	T EH L B AH T
TELLING	T EH L IH NG
TELLING.	T EH L IH NG
TELLS	T EH L Z
TEMPLE'S	T EH M P AH L Z
TEN	T EH N
TEN.	T EH N
TEN.TITLE	T EH N T AY T AH L
TENDED	T EH N D AH D
TENDED(2)	T EH N D IH D
TENDENCY	T EH N D AH N S IY
TENSE	T EH N S
TENSION	T EH N SH AH N
TENSION,	T EH N CH AH N
TENSION.	T EH N CH AH N
TERMED	T ER M D
TERMINALLY	T ER M AH N AH L IY
TERRIBLE	T EH R AH B AH L
TERRIFIC,	T AH R IH F IH K
TERRIFYING	T EH R AH F AY IH NG
TESTAMENTS	T EH S T AH M AH N T S
TESTING	T EH S T IH NG
TEXTURED	T EH K S CH ER D
THAN	DH AE N
THAN(2)	DH AH N
THANK	TH AE NG K
THANKFULLY	TH AE NG K F AH L IY
THANKS	TH AE NG K S
THANKS!	TH AE NG K S
THAT	DH AE T
THAT(2)	DH AH T
THAT'S	DH AE T S
THAT,	DH AE T
THAT.	DH AE T
THAT...IT'S	DH AE T IH T S
THAW	TH AO
THE	DH AH
THE(2)	DH IY
THEATER	TH IY EY T ER
THEATER.	TH IY AH T ER
THEATERS.	TH IY AH T ER Z
THEE	DH IY
THEIR	DH EH R
THEM	DH EH M
THEM(2)	DH AH M
THEM'.	TH EH M
THEM)WASH	DH EH M W AA SH
THEM,	DH EH M
THEM.	DH EH M
THEME	TH IY M
THEMES	TH IY M Z
THEMSELVES	DH EH M S EH L V Z
THEMSELVES(2)	DH AH M S EH L V Z
THEMSELVES.	DH EH M S EH L V Z
THEMSELVES.IZUMO	DH EH M S EH L V Z AH Z UW M OW
THEMSELVES?	DH EH M S EH L V Z
THEN	DH EH N
THEN,	DH EH N
THEN...	DH EH N
THERE	DH EH R
THERE'S	DH EH R Z
THERE,	DH EH R
THERE.	DH EH R
THERE.IN	DH EH R IH N
THERE.THIS	DH EH R DH IH S
THERE?"")	DH EH R
THEREFORE	DH EH R F AO R
THESE	DH IY Z
THEY	DH EY
THEY'RE	DH EH R
THICKENS	TH IH K AH N Z
THICKENS....IZUMO	TH IH K AH N Z AH Z UW M OW
THIN	TH IH N
THING	TH IH NG
THING.I	TH IH NG AY
THING.THE	TH IH NG DH AH
THINGS	TH IH NG Z
THINGS.	TH IH NG Z
THINK	TH IH NG K
THINK,	TH IH NG K
THINKING	TH IH NG K IH NG
THIRD	TH ER D
THIRST	TH ER S T
THIRST.",10,POS	T IY EY CH AY AA R EH S T IY W AH N Z IY R OW P IY OW EH S
THIRTY	TH ER D IY
THIRTY-SOMETHING,	TH ER D IY S AH M TH IH NG
THIS	DH IH S
THIS.	DH IH S
THIS.",10,POS	T IY EY CH AY EH S W AH N Z IY R OW P IY OW EH S
THIS.DESPITE	DH IH S D IH S P AY T
THOMAS,	T AA M AH S
THOMPSON.THE	T AA M P S AH N DH AH
THOSE	DH OW Z
THOUGH	DH OW
THOUGH,	DH OW
THOUGHT	TH AO T
THOUGHTFUL	TH AO T F AH L
THREAT	TH R EH T
THREAT,	TH R EH T
THREATENED	TH R EH T AH N D
THREE	TH R IY
THREE,	TH R IY
THRILLER	TH R IH L ER
THRILLER.	TH R IH L ER
THRILLING	TH R IH L IH NG
THROUGH	TH R UW
THROUGH.	TH R UW
THROUGHOUT	TH R UW AW T
THROW	TH R OW
THROWING	TH R OW IH NG
THROWN	TH R OW N
THUMBS	TH AH M Z
THUS	DH AH S
THUS,	DH AH S
TICKETS	T IH K AH T S
TICKETS(2)	T IH K IH T S
TIED-UP	T AY D AH P
TIGHTLY	T AY T L IY
TILL	T IH L
TIME	T AY M
TIME),	T AY M
TIME).THE	T AY M DH AH
TIME,	T AY M
TIME.	T AY M
TIME.",10,POS	T IY AY EH M IY W AH N Z IY R OW P IY OW EH S
TIME.THIS	T AY M DH IH S
TIME.WHERE	T AY M W EH ER
TIME?	T AY M
TIMES	T AY M Z
TIMES"".	T AY M Z
TIMES,	T AY M Z
TIMOTHY	T IH M AH TH IY
TINGLER!	T IH NG G AH L ER
TINGLER.THIS	T IH NG G AH L ER DH IH S
TIRE	T AY ER
TITLE	T AY T AH L
TITLE.	T AY T AH L
TITLES,	T AY T AH L Z
TO	T UW
TO(2)	T IH
TO(3)	T AH
TO.	T UW
TOBY	T OW B IY
TODAY	T AH D EY
TODAY(2)	T UW D EY
TODAY,	T AH D EY
TODAY.	T AH D EY
TOGETHER	T AH G EH DH ER
TOGETHER'.	T AA JH AH TH AH R
TOGETHER,	T AH G EH DH ER
TOILET	T OY L AH T
TOKYO	T OW K IY OW
TOLD	T OW L D
TOLD.	T OW L D
TOM	T AA M
TOM'S	T AA M Z
TOM,	T AA M
TOMMY	T AA M IY
TONE	T OW N
TONI	T OW N IY
TONY	T OW N IY
TOO	T UW
TOO,	T UW
TOO.	T UW
TOOK	T UH K
TOP	T AA P
TOP(2)	T AO P
TOPICS	T AA P IH K S
TORN	T AO R N
TOSS	T AO S
TOTAL	T OW T AH L
TOTALLY	T OW T AH L IY
TOUCH	T AH CH
TOUCHES	T AH CH AH Z
TOUCHES(2)	T AH CH IH Z
TOUCHING	T AH CH IH NG
TOUGH	T AH F
TOUGH,	T AH F
TOURIST	T UH R AH S T
TOURIST(2)	T UH R IH S T
TOW	T OW
TOWARD	T AH W AO R D
TOWARD(2)	T AO R D
TOWN	T AW N
TOWN,	T AW N
TOWN.	T AW N
TRACE	T R EY S
TRACK	T R AE K
TRADITIONS	T R AH D IH SH AH N Z
TRAGEDY.	T R AE JH AH D IY
TRAGIC	T R AE JH IH K
TRAIN	T R EY N
TRAINED	T R EY N D
TRAIT	T R EY T
TRANS,	T R AE N Z
TRANSFORMS	T R AE N S F AO R M Z
TRANSGRESSIONS	T R AE N Z G R EH SH AH N Z
TRANSLATION,	T R AE N S L EY SH AH N
TRANSVESTITISM	T R AE N Z EH S T AH T IH Z AH M
TRAP""	T R AE P
TRAPPED	T R AE P T
TRAUMA	T R AO M AH
TRAUMATIZED	T R AO M AH T AY Z D
TRAVEL	T R AE V AH L
TRAVELER,	T R AE V AH L ER
TREACHEROUS	T R EH CH ER AH S
TREASURE.	T R EH ZH ER
TREAT	T R IY T
TREAT!!",10,POS	T IY AA R IY EY T IY W AH N Z IY R OW P IY OW EH S
TREATED	T R IY T AH D
TREATED(2)	T R IY T IH D
TREATING	T R IY T IH NG
TREATS	T R IY T S
TREK	T R EH K
TREMAINE	T R IH M EY N
TREMENDOUS	T R AH M EH N D AH S
TREMENDOUS(2)	T R IH M EH N D AH S
TRIAD	T R AY AE D
TRIADS	T R AY AE D Z
TRIBUTE	T R IH B Y UW T
TRICKS	T R IH K S
TRIED	T R AY D
TRIES	T R AY Z
TRIFIRI	T R IH F AH R IY
TRIFIRI.	T R IH F AH R IY
TRIFLE	T R AY F AH L
TRIP	T R IH P
TROUBLE	T R AH B AH L
TROUBLE.	T R AH B AH L
TROUBLED	T R AH B AH L D
TRUCK	T R AH K
TRUE	T R UW
TRUE,	T R UW
TRUE?'",10,POS	T IY AA R Y UW IY L EH T AH R W AH N Z IY R OW P IY OW EH S
TRULY	T R UW L IY
TRUST.BUT	T R AH S T B AH T
TRUSTS	T R AH S T S
TRUTH,	T R UW TH
TRUTHS	T R UW TH S
TRY	T R AY
TRYING	T R AY IH NG
TRYING(2)	T R AY NG
TSUBAKI.	T S UW B AH K IY
TUBE	T UW B
TUBE(2)	T Y UW B
TUCCI	T UW CH IY
TUESDAY	T UW Z D IY
TUESDAY(2)	T UW Z D EY
TUESDAY(3)	T Y UW Z D EY
TUMULTUOUS	T UW M AH L CH UW AH S
TUNES	T UW N Z
TURKEY	T ER K IY
TURKEY(USA'S	T ER K IY Y UW S AH Z
TURKISH	T ER K IH SH
TURMOIL	T ER M OY L
TURN	T ER N
TURNING	T ER N IH NG
TURNS	T ER N Z
TV	T IY V IY
TV(2)	T EH L AH V IH ZH AH N
TV,	T IY V IY
TV.",7,POS	T IY V IY S EH V AH N P IY OW EH S
TV...	T IY V IY
TV.IN	T V IH N
TWELVE	T W EH L V
TWENTY	T W EH N T IY
TWICE	T W AY S
TWIST	T W IH S T
TWISTS	T W IH S T S
TWO	T UW
TWO,	T UW
TWO-DAY	T UW D EY
TYPE	T AY P
TYPE.	T AY P
TYPICAL	T IH P AH K AH L
TYPICAL(2)	T IH P IH K AH L
TYPICALLY	T IH P IH K L IY
TYPICALLY(2)	T IH P IH K AH L IY
TYRANT,	T AY R AH N T
UC	AH K
ULTIMATE	AH L T AH M AH T
ULTIMATELY,	AH L T AH M AH T L IY
ULTRA	AH L T R AH
ULTRA-LOW	AH L T R AH L OW
UNAPPEALING	AH N AH P IY L IH NG
UNCLE	AH NG K AH L
UNCLE.""	AH NG K AH L
UNCOMFORTABLE	AH N K AH M F ER T AH B AH L
UNDER	AH N D ER
UNDERACHIEVING	AH N D ER AH CH IY V IH NG
UNDERCOVER	AH N D ER K AH V ER
UNDERHAND	AH N D ER HH AE N D
UNDERLYING	AH N D ER L AY IH NG
UNDERRATED	AH N D ER R EY T IH D
UNDERSTAND	AH N D ER S T AE N D
UNDERSTAND,	AH N D ER S T AE N D
UNDERSTANDS	AH N D ER S T AE N D Z
UNDERWATER	AH N D ER W AO T ER
UNDERWHELMED	AH N D ER W EH L M D
UNDOUBTEDLY	AH N D AW T IH D L IY
UNEVEN	AH N IY V AH N
UNEXPECTEDLY	AH N IH K S P EH K T IH D L IY
UNFAIR	AH N F EH R
UNFAIR(2)	AO N F EH R
UNFAIRLY,	AH N F EH R L IY
UNFAITHFUL	AH N F EY TH F AH L
UNFOLDING	AH N F OW L D IH NG
UNFOLDS	AH N F OW L D Z
UNFORGETTABLE	AH N F ER G EH T AH B AH L
UNFORTUNATELY,	AH N F AO R CH AH N AH T L IY
UNHOLY	AH N HH OW L IY
UNINSPIRED	AH N IH N S P AY ER D
UNINTENTIONALLY	AH N IH N T EH N SH AH N AH L IY
UNINTENTIONALLY(2)	AH N IH N T EH N SH N AH L IY
UNIONS	Y UW N Y AH N Z
UNIQUE	Y UW N IY K
UNIQUE,	Y UH N IY K
UNIT	Y UW N AH T
UNIT(2)	Y UW N IH T
UNIVERSE,	Y UW N AH V ER S
UNKNOWN	AH N N OW N
UNKNOWN,	AH N OW N
UNLESS	AH N L EH S
UNLIKABLE	AH N L AY K AH B AH L
UNLIKE	AH N L AY K
UNNECESSARY	AH N N EH S AH S EH R IY
UNNERVING	AH N ER V IH NG
UNOFFICIAL	AH N AH F IH SH AH L
UNSETTLING	AH N S EH T AH L IH NG
UNSETTLING(2)	AH N S EH T L IH NG
UNSURPASSED,	AH N S ER P AE S T
UNTAMED	AH N T EY M D
UNTIL	AH N T IH L
UNWILLINGNESS	AH N W IH L IH NG N IH S
UP	AH P
UP!!",9,POS	Y UW P IY N AY N P IY OW EH S
UP,	AH P
UP.	AH P
UPON	AH P AA N
UPS,	AH P S
UPSET	AH P S EH T
URBANE	ER B EY N
URDHU,	AH R D HH UW
URGENCY	ER JH AH N S IY
US	AH S
US(2)	Y UW EH S
US)	AH S
USAF	Y UW S AH F
USED	Y UW Z D
USELESS	Y UW S L AH S
USER	Y UW Z ER
USES	Y UW S AH Z
USES(2)	Y UW S IH Z
USES(3)	Y UW Z AH Z
USES(4)	Y UW Z IH Z
USING	Y UW Z IH NG
USUAL	Y UW ZH AH W AH L
USUAL(2)	Y UW ZH UW AH L
USUALLY	Y UW ZH AH W AH L IY
USUALLY(2)	Y UW ZH AH L IY
VACATION	V EY K EY SH AH N
VACATION.	V EY K EY SH AH N
VACHTANGI(BENJAMIN)	V AE CH T AE N JH IY B EH N JH AH M AH N
VAL	V AE L
VALID	V AE L IH D
VALUE	V AE L Y UW
VAMPIRE	V AE M P AY R
VAMPIRISM	V AE M P AY ER IH Z AH M
VAN	V AE N
VANCE	V AE N S
VAPORIZES	V EY P ER AY Z IH Z
VARIETY	V ER AY AH T IY
VASSILIS	V AE S AH L AH S
VEHICLE	V IY HH IH K AH L
VEHICLE(2)	V IY IH K AH L
VEIL	V EY L
VENEZUELA	V EH N IH Z W EY L AH
VERBAL	V ER B AH L
VERGE	V ER JH
VERSION	V ER ZH AH N
VERSION,	V ER ZH AH N
VERSION.	V ER ZH AH N
VERSIONS	V ER ZH AH N Z
VERSIONS,	V ER ZH AH N Z
VERY	V EH R IY
VIA	V AY AH
VIA(2)	V IY AH
VIBRATORS	V AY B R AH T ER Z
VICISSITUDES	V IH S IH S IH T UW D Z
VICTIM	V IH K T IH M
VICTORY	V IH K T AH R IY
VIDEO	V IH D IY OW
VIE).IT	V AY IH T
VIENNA	V IY EH N AH
VIENNA'S	V IY EH N AH Z
VIES	V AY Z
VIETNAM""	V IY T N AH M
VIEW	V Y UW
VIEW.WHY	V Y UW W AY
VIEWED	V Y UW D
VIEWER	V Y UW ER
VIEWER,	V Y UW ER
VIEWERS	V Y UW ER Z
VIEWING	V Y UW IH NG
VIEWING.IN	V Y UW IH NG IH N
VIEWS,	V Y UW Z
VILLA	V IH L AH
VILLAIN	V IH L AH N
VILLAINS,	V IH L AH N Z
VINCENTE	V IH N CH EH N T IY
VINGANçA""	V IH N G AH N AH
VIOLENCE	V AY AH L AH N S
VIOLENCE.	V AY AH L AH N S
VIOLENT	V AY AH L AH N T
VIRILE	V IH R AH L
VISION	V IH ZH AH N
VISIONS	V IH ZH AH N Z
VISIONS,	V IH ZH AH N Z
VISIT	V IH Z IH T
VISUALS	V IH ZH W AH L Z
VISUALS,	V IH ZH AH W AH L Z
VITAL	V AY T AH L
VOCAL	V OW K AH L
VOICE	V OY S
VOIGHT).WHAT	V OY T W AA T
VOLUME	V AA L Y UW M
VOLUNTEERING	V AO L AH N T IH R IH NG
VON	V AO N
VOTE	V OW T
VOYAGE	V OY AH JH
VS.	V IY EH S
VU	V UW
VULNERABILITY	V AH L N ER AH B IH L IH T IY
VULNERABLE.	V AH L N ER AH B AH L
WAITING	W EY T IH NG
WALKEN	W AO K AH N
WALKEN),	W AO K AH N
WALKING	W AO K IH NG
WALSH)	W AA L SH
WANT	W AA N T
WANT(2)	W AO N T
WANTED	W AO N T IH D
WANTING	W AA N T IH NG
WANTING(2)	W AA N IH NG
WANTS	W AA N T S
WANTS(2)	W AO N T S
WAR	W AO R
WARDEN,	W AO R D AH N
WARDENS""	W AO R D AH N Z
WARDENS,	W AO R D AH N Z
WARN	W AO R N
WARNING:	W AO R N IH NG
WARRIORS,	W AA R IY ER Z
WARS',	W AA R Z
WAS	W AA Z
WAS,	W AH Z
WAS.	W AH Z
WAS.HE	W AH Z HH IY
WAS.THE	W AH Z DH AH
WASHINGTON)	W AO SH IH NG T AH N
WASHINGTON,	W AO SH IH NG T AH N
WASN'T	W AA Z AH N T
WASN'T(2)	W AH Z AH N T
WASN'T.	W AH Z AH N T
WASTE.	W EY S T
WATCH	W AA CH
WATCH(2)	W AO CH
WATCH,	W AA CH
WATCH.	W AA CH
WATCHABLE	W AA CH AH B AH L
WATCHED	W AA CH T
WATCHED(2)	W AO CH T
WATCHES	W AA CH AH Z
WATCHES(2)	W AA CH IH Z
WATCHING	W AA CH IH NG
WATER	W AO T ER
WATERS	W AO T ER Z
WATERS,	W AO T ER Z
WAY	W EY
WAY!	W EY
WAY,	W EY
WAY.	W EY
WAY.PARKER	W EY P AA R K ER
WAYNE	W EY N
WAYS	W EY Z
WE	W IY
WE,	W IY
WEAK	W IY K
WEAKNESS	W IY K N AH S
WEAKNESSES,	W IY K N AH S IH Z
WEALTHY	W EH L TH IY
WEBER	W EH B ER
WEBER,	W EH B ER
WEEK,	W IY K
WEEKS	W IY K S
WEIRD	W IH R D
WEIRD,	W IH ER D
WEIRDLY	W IH R D L IY
WEIRDNESS	W IH R D N AH S
WELCOMED.	W EH L K AH M D
WELD	W EH L D
WELL	W EH L
WELL,	W EH L
WELL-DEVELOPED,	W EH L D IH V EH L AH P T
WELL-DONE	W EH L D AH N
WELL-LIKED	W EH L L AY K T
WELL-MADE	W EH L M EY D
WELL-VERSED	W EH L V ER S T
WELL.	W EH L
WELLES	W EH L Z
WELLES'	W EH L Z
WELLES)	W EH L Z
WELLES,	W EH L Z
WELLS	W EH L Z
WENT	W EH N T
WERCHING	W AH R CH AH NG
WERE	W ER
WERE,	W ER
WEREN'T	W ER AH N T
WEREN'T(2)	W ER N T
WESTERN,	W EH S T ER N
WESTPOINT	W EH S T P OY N T
WET	W EH T
WHA	W AA
WHAT	W AH T
WHAT(2)	HH W AH T
WHAT.	W AA T
WHATEVER	W AH T EH V ER
WHATEVER(2)	HH W AH T EH V ER
WHATSOEVER,	W AA T S AH W EH V ER
WHEN	W EH N
WHEN(2)	HH W EH N
WHEN(3)	W IH N
WHEN(4)	HH W IH N
WHERE	W EH R
WHERE(2)	HH W EH R
WHETHER	W EH DH ER
WHETHER(2)	HH W EH DH ER
WHICH	W IH CH
WHICH(2)	HH W IH CH
WHICH,	W IH CH
WHILE	W AY L
WHILE(2)	HH W AY L
WHILE,	W AY L
WHILE.	W AY L
WHILST	W AY L S T
WHIMSICAL	W IH M Z IH K AH L
WHIMSICAL(2)	HH W IH M Z IH K AH L
WHISPER	W IH S P ER
WHISPER(2)	HH W IH S P ER
WHITE,	W AY T
WHO	HH UW
WHO'S	HH UW Z
WHO.	HH UW
WHOA	W OW
WHOA(2)	HH W OW
WHOA(3)	HH OW
WHOEVER	HH UW EH V ER
WHOLE	HH OW L
WHOLE.	HH OW L
WHOM	HH UW M
WHOSE	HH UW Z
WHY	W AY
WHY(2)	HH W AY
WICKED	W IH K AH D
WIDE	W AY D
WIFE	W AY F
WIFE'S,	W AY F S
WIFE,	W AY F
WIFE.	W AY F
WILD	W AY L D
WILD.	W AY L D
WILDERNESS	W IH L D ER N AH S
WILDLIFE	W AY L D L AY F
WILL	W IH L
WILL(2)	W AH L
WILL!,10,POS	D AH B AH L Y UW AY EH L EH L W AH N Z IY R OW P IY OW EH S
WILL.	W IH L
WILLIAM	W IH L Y AH M
WILLIAMS	W IH L Y AH M Z
WILLIAMS)	W IH L Y AH M Z
WILLS	W IH L Z
WIN	W IH N
WIN.",10,POS	D AH B AH L Y UW AY EH N W AH N Z IY R OW P IY OW EH S
WINCHESTER	W IH N CH EH S T ER
WINCING	W IH N S IH NG
WIND	W AY N D
WIND(2)	W IH N D
WINNING	W IH N IH NG
WINTER	W IH N T ER
WISDOM	W IH Z D AH M
WISE	W AY Z
WISEMAN.	W AY Z M AE N
WISH	W IH SH
WISHED	W IH SH T
WITCH	W IH CH
WITCH,	W IH CH
WITCHCRAFT	W IH CH K R AE F T
WITCHES	W IH CH AH Z
WITCHES(2)	W IH CH IH Z
WITH	W IH DH
WITH(2)	W IH TH
WITH,	W IH TH
WITH.	W IH TH
WITHERSPOON	W IH DH ER S P UW N
WITHIN	W IH DH IH N
WITHIN(2)	W IH TH IH N
WITHOUT	W IH TH AW T
WITHOUT(2)	W IH DH AW T
WITTY	W IH T IY
WITTY,	W IH T IY
WOLFE	W UH L F
WOMAN	W UH M AH N
WOMAN'S	W UH M AH N Z
WOMAN.	W UH M AH N
WOMEN	W IH M AH N
WON	W AH N
WON(2)	W AA N
WON'T	W OW N T
WONDER	W AH N D ER
WONDERED	W AH N D ER D
WONDERFUL	W AH N D ER F AH L
WONDERFULLY	W AH N D ER F AH L IY
WONDERFULLY(2)	W AH N D ER F L IY
WONDERING	W AH N D ER IH NG
WONDERLAND,	W AH N D ER L AE N D
WONDERS	W AH N D ER Z
WONT	W OW N T
WOODS	W UH D Z
WORD	W ER D
WORD.	W ER D
WORDS	W ER D Z
WORK	W ER K
WORK,	W ER K
WORK---I	W ER K
WORK.",10,POS	D AH B AH L Y UW OW AA R K EY W AH N Z IY R OW P IY OW EH S
WORKED	W ER K T
WORKING	W ER K IH NG
WORKING)	W ER K IH NG
WORKS	W ER K S
WORKS,	W ER K S
WORLD	W ER L D
WORLD'	W ER L D
WORLD,	W ER L D
WORLD.	W ER L D
WORLD.",10,POS	D AH B AH L Y UW OW AA R EH L D IY W AH N Z IY R OW P IY OW EH S
WORLD?	W ER L D
WORLDLIER	W ER L D L IY ER
WORRY	W ER IY
WORST	W ER S T
WORTH	W ER TH
WOULD	W UH D
WOULDN'T	W UH D AH N T
WOUND	W AW N D
WOUND(2)	W UW N D
WOURNOW	W AH R N OW
WOW,	W AW
WRENCHING	R EH N CH IH NG
WRITER	R AY T ER
WRITERS	R AY T ER Z
WRITING	R AY T IH NG
WRITTEN	R IH T AH N
WRONG	R AO NG
WRONG.	R AO NG
WWI.	W IY
WYOMING,	W AY OW M AH NG
X.	EH K S
X.(2)	AE K S
XVICHIA,SERGO	Z V IH CH IY AH S AH R G OW
YALL,	Y AE L
YANK	Y AE NG K
YEAH	Y AE
YEAR	Y IH R
YEARS	Y IH R Z
YEARS,	Y IH ER Z
YEARS,SINATRA	Y IH ER Z S AH N AE T R AH
YEARS.	Y IH ER Z
YELL	Y EH L
YEP,	Y EH P
YES	Y EH S
YES,	Y EH S
YET	Y EH T
YET,	Y EH T
YET.	Y EH T
YOAKAM	Y OW K AH M
YOJIRO	Y AA JH AH R OW
YORK,	Y AO R K
YOU	Y UW
YOU'	Y UW
YOU'D	Y UW D
YOU'D(2)	Y UH D
YOU'LL	Y UW L
YOU'VE	Y UW V
YOU,	Y UW
YOU.	Y UW
YOU.....ENJOY	Y UW EH N JH OY
YOU?""	Y UW
YOUNG	Y AH NG
YOUNG""	Y AH NG
YOUNG--UNLESS	Y AH NG
YOUNGER	Y AH NG G ER
YOUR	Y AO R
YOUR(2)	Y UH R
YOURSELF	Y ER S EH L F
YOURSELF(2)	Y UH R S EH L F
YOURSELF(3)	Y AO R S EH L F
YR	Y R
ZAKARIADZE,SOFIKO	Z AH K AE R IY AH D Z S AA F AH K OW
ZAKU	Z AE K UW
ZED	Z EH D
ZEITGEIST,	T S AY T G AY S T
ZELAH	Z EH L AH
ZEON	Z IY AH N
ZOMBI.	Z AA M B IY
ZOMBIE	Z AA M B IY
ZONE	Z OW N
ZONES.WE'LL	Z OW N Z W IY L
`LEFT	L EH F T
